Hhd^Fms, Hhd^Fms, Hhd^Fms, Hhd^Fms, Gs^Fds, Gs^Fms, Hhd^Fmf, Gs^Fms, Gs^Fds, Gs^Fds, Gs^Fds, Gs^Fds, Gd, Gs^Fds, Gs^Fds, Gs^Fds, Hhd, Gs^Fms, Gs^Fms, Gs^Fms, Gs^Fms, Gs^Fds, Gs^Fds, Gs^Fds, Gs^Fds, Gs^Fds, Gs^Fms, Gs^Fds, Hhd^Fdf, Gs^Fds, Hhd, Gd, Hhd^Fms, Gd, Gd
Mm, Mm, Hhd^Fms, Hhd^Fms, Hhd^Fdf, Hhd^Fmf, Gs^Fmf, Gs^Fmf, Gs^Fms, Gs^Fds, Gd^Efm, Gll^Efm, Gd^Efm, Gd^Efm, Gs^Fds, Hhd^Fms, Hhd, Gs^Fms, Gg^Ve, Gs^Fds, Hhd, Gs^Fms, Hhd^Fms, Gs, Hhd^Fms, Gs, Gs^Fms, Hhd^Fmf, Hhd^Fdf, Gs^Fdf, Gs^Fdf, Hhd^Fmf, Hhd^Fms, Hhd^Fms, Hhd^Fms
Mm, Mm^Xm, Mm, Gs^Fds, Hhd^Fdf, Hhd^Fdf, Gs^Fmf, Gs^Fmf, Gs^Fmf, Gs^Fms, Gg^Ve, Gs^Efm, Gs, Gs^Fds, Gs^Fms, Gs^Fmf, Hhd, Hhd^Fms, Hhd^Fms, Gs^Fms, Hhd, Hhd, Gs^Fdf, Gs^Fmf, Hhd^Fms, Gs^Efm, Gd, Hhd^Fms, Hhd^Fmf, Hhd^Fdf, Hhd^Fms, Hhd^Fms, Hhd, Hhd, Hhd^Fms
Mm, Mm, Mm, Hhd, Hhd^Fdf, Gs^Fdf, Gs, Gs^Fmf, Gs^Fms, Gs^Fds, Gs^Fms, Gs^Fds, Gs^Efm, Gll, Gs^Fmf, Hhd^Fmf, Hhd^Fms, Hhd^Fdf, Hhd^Fdf, Gs^Fdf, Hhd^Fdf, Hhd^Fdf, Hhd^Fdf, Hhd^Fdf, Hhd^Fms, Gs^Efm, Gs^Fms, Gd, Gs^Fms, Gs^Fms, Gs, Gd, Hhd^Fms, Hhd^Fms, Hhd^Fms
Hhd, Mm, Hhd^Fms, Hhd^Fms, Hhd^Fdf, Gs^Fdf, Gs^Fmf, Gs^Fmf, Gs^Fms, Gs^Fms, Gs^Fms, Gs^Fds, Gs, Gs, Gs^Fds, Hhd^Fmf, Gs^Fmf, Gs^Efm, Gs^Fmf, Hhd^Fdf, Hhd, Hhd, Hhd^Fdf, Hhd^Fdf, Gs^Fmf, Gs, Gs^Fms, Gd, Gs^Fms, Gs, Gs^Efm, Gs, Hhd, Mm, Mm
Hhd^Fms, Hhd, Hhd^Fmf, Hhd^Fdf, Gs^Fds, Gs^Fmf, Gs^Fmf, Gs^Fds, Cv, Cv, 2 Kv, Gs, Gs^Fds, Gs^Fds, Gd, Gs^Fmf, Gs^Fmf, Gs^Fmf, Gs^Fmf, Gs^Fmf, Hhd^Fms, Hhd^Fmf, Hhd^Fmf, Gs^Fdf, Hhd^Fmf, Gs^Fms, Gll^Efm, Gs, Gs, Gll^Efm, Gd^Efm, Hhd^Fms, Mm, Mm^Xm, Mm
Gd, Hhd^Fms, Gs^Fds, Gs^Fms, Gll, Gs^Fms, Gs^Fds, Gs^Fds, 1 Kv, Gg^Fet, Cv, Gs, Gs, Gs^Efm, Gll, Gs^Fms, Gs^Fms, Hhd^Fms, Hhd^Fms, Hhd^Fms, Gg^Ve, Gs^Fmf, Hhd^Fms, Hhd^Fmf, Hhd^Fms, Gs^Fmf, Gs, Gs, Gs^Fms, Gs, Hhd^Fdf, Gs^Fms, Mm^Fdf, Mm, Mm
Gs^Fds, Gs^Fds, Gs^Fds, Gs^Fds, Gs^Fds, Gg^Ve, Gs, Gs^Fds, Gs, Cv, Gs, Gs, Gs^Efm, Gs^Efm, Gs, Gs^Fms, Gs, Gd, Cv, Gs^Fds, Hhd^Fms, Hhd^Fms, Gs^Fds, Hhd^Fms, Gs^Fds, Gs^Efm, Gll^Efm, Gd^Efm, Hhd^Fms, Hhd^Fdf, Cv, Gll^Fdf, Hhd^Fmf, Hhd^Fms, Mm
Gd, Gs^Fds, Gs, Gs^Fds, Gs^Fds, Gll^Efm, Gs^Efm, Gs, Gs, Gs, Gs, Gs, Gs, Gs, Gs, Gs, Gd, Gs, Gs, Gs^Fds, Hhd^Fms, Gs^Fds, Gs^Fds, Hhd^Fms, Gll^Em, Gd, Gs^Fms, Gd, Gs^Fms, Gll^Fmf, Gll^Fdf, Hhd^Fmf, Gd, Hhd^Fmf, Hhd^Fms
Gs^Fds, Gs, Gd, Gs^Efm, Gs, Gs^Efm, Gll^Efm, Gs^Efm, Gs, Gs, Gs^Efm, Gs^Fds, Gs^Fms, Gs^Fds, Gs^Fms, Gs^Fms, Gs^Efm, Gd^Es, Gd, Gs, Gs, Gs, Gs, Gd, Gs, Gs^Efm, Gd, Gs^Fms, Gs^Efm, Gs^Fmf, Gs^Fms, Hhd^Fms, Gs, Hhd^Fmf, Hhd^Fms
Gs^Fds, Gs^Fds, Gs^Fdf, Gs^Fds, Hhd^Fmf, Gs^Fds, Gs^Fds, Gll, Gs^Fms, Gs^Fms, Gs, Gs^Fms, Hhd^Fms, Cv, Gs^Fds, Gs, Gd, Gd, Gs, Gs, Gs, Gs, Gs^Efm, Gs, Gd^Es, Gd, Gs^Efm, Gs, Gs^Efm, Gs^Efm, Gs^Efm, Gs^Fms, Gd, Gd^Em, Gd
Hhd, Hhd^Fdf, Hhd^Fdf, Hhd^Fdf, Gs^Fdf, Gs^Fds, Gs^Fds, Gs^Fmf, Hhd^Fdf, Gs^Fms, Gs^Fmf, Hhd^Fms, Hhd^Fdf, Hhd^Fms, Hhd^Fms, Hhd^Fms, Gs, Gs, Gs^Efm, Gs^Efm, Gs^Efm, Gs^Efm, Gd^Efm, Gd, Gs, Gd, Gs, Gs^Efm, Gs, Gd^Es, Gd^Es, Gd, Gs^Fms, Gs^Fms, Gd
Hhd^Fms, Hhd, Hhd^Fdf, Hhd^Fdf, Gd^Efm, Gd^Efm, Gs^Fms, Hhd^Fdf, Gs^Fds, Hhd^Fms, Gs^Fdf, Hhd^Fdf, Hhd^Fmf, Hhd^Fms, Gs^Fds, Gs^Fds, Gd, Gs, Gs^Efm, Gs^Efm, Gd^Efm, Gd^Efm, Gd, Gd, Gs, Gs, Gd^Es, Gs, Gs^Efm, Gs^Efm, Gs, Gs^Fms, Gll, Gs^Fms, Gs^Fms
Gd, Hhd^Fmf, Gs^Fds, Gs^Fds, Gd^Fdf, Gd^Efm, Gs^Fmf, Gs^Fmf, Gs, Gs^Fds, Cv, Hhd^Fdf, Gs^Fms, Gs^Fmf, Gs^Fds, Gs^Fds, Gd, Gs, Gs, Gs, Gs, Gd, Gs, Gs, Gd, Gd^Es, Gs, Gs^Efm, Gs, Gs^Efm, Gs, Gs, Gs, Gs, Gs
Gs^Fds, Gs^Fms, Gg^Ve, Gs^Fdf, Gs^Fdf, Gs^Fms, Gs^Fms, Gs^Fms, Gs, Gs^Fds, Gs^Fds, Gs^Fds, Gs^Fds, Gs^Fds, Gs, Gs, Gs, Gs, Gd, Gs, Gd, Gs, Gd, Gd, Gd^Efm, Gd, Gs, Gs, Gd, Gs, Gd, Gd^Es, Gd, Gs, Gs
Gs^Fds, Gs^Fms, Gs^Fds, Gs^Fmf, Cv, Gs^Fms, Gs^Fds, Gs^Efm, Gd^Efm, Gs^Efm, Gd, Gs^Fds, Gd, Gs^Fds, Gs^Efm, Gs^Efm, Gd, Gd^Efm, Gd, Gd, Gd, Gd, Gd, Gd^Efm, Gd, Gd, Gd^Efm, Gd, Gd^Es, Gs, Gs, Gs, Gd, Gs, Gd^Es
Gs^Fds, Gs^Fds, Gll^Em, Gs^Fds, Gll, Gd, Gs, Gd, Gs^Fds, Gs^Fdf, Gs^Fds, Gd, Gd^Efm, Gd, Gs^Es, Gs, Gs^Efm, Gd, Gd, Gd, Gd, Gd, Gd, Gd, Gd, Gd, Gd, Gd^Efm, Gd^Efm, Gd^Efm, Gd, Gd^Es, Gd, Gd, Gd
Gs^Fds, Gs^Fds, Gs^Efm, Hhd^Fms, Gd, Gd, Gs^Efm, Gs^Efm, Gs^Efm, Gs^Fdf, Gd, Gd, Gd^Es, Gs, Gd, Gs, Gd, Gs, Gd, Gd, Gd, Gd, Gd, Gd, Gd, Gd, Gd, Gd, Gd^Es, Gd, Gd, Gd, Gd, Gd, Gd
Gs^Fds, Gs^Efm, Hhd^Fms, Gs^Efm, Gs, Gd, Gs, Gs, Gd^Efm, Gs^Efm, Gd, Gs^Efm, Gd^Efm, Gd, Gd, Gd, Gd, Gd, Gd^Efm, Gd^Es, Gd, Gd^Es, Gd, Gd^Es, Gd, Gd^Es, Gd, Gd, Gd^Es, Gd^Es, Gd^Es, Gd^Es, Gd, Gd, Gd
Hhd^Fms, Hhd^Fms, Hhd^Fms, Hhd^Fms, Hhd^Fms, Gs^Fms, Gs, Gs^Fds, Gs, Gs^Efm, Gs, Gd, Gs^Fmf, Gs^Fmf, Hhd^Fms, Gd, Gs, Gd^Efm, Gd^Efm, Gd^Efm, Gd, Gd, Gd, Gd, Gd, Gd, Gd, Gd, Gd, Gd, Gd, Gd, Gd, Gd, Gd
Mm, Hhd^Fms, Hhd, Hhd^Fms, Gs^Fmf, Gs^Fms, Gs^Fmf, Gs^Fds, Hhd^Fms, Gs, Gd^Efm, Gs^Fms, Gs^Fms, Hhd^Fms, Gd, Gs, Gs, Gd, Gd^Efm, Gd, Gd^Es, Gs, Gd, Gd, Gd, Gd, Gd, Gd, Gd, Gd, Gd, Gd, Gd, Gd, Gd
Mm, Mm^Xm, Mm, Hhd, Gs^Fmf, Gs^Fmf, Hhd^Fms, Gs^Fdf, Gs^Fmf, Gd, Hhd^Fdf, Gd, Gs^Fmf, Gs^Fms, Hhd^Fmf, Hhd^Fms, Gs, Gd, Gs, Gs, Gd, Gd, Gd^Es, Gd, Gd, Gd, Gd, Gd, Gd, 3 Gd, Gd^Es, Gd, Gd, Gd, Gd
Hhd^Fms, Mm, Mm, Gs^Fmf, Gs^Fdf, Gs^Fmf, Gs^Fdf, Gs^Fdf, Hhd^Fdf, Hhd^Fdf, Hhd^Fms, Hhd^Fms, Gs^Fmf, Gs^Fdf, Hhd^Fmf, Gs^Fmf, Hhd^Fmf, Gs, Gs, Gd, Gd, Gd, Gd, Gd^Es, Gd, Gd, Gd, Gd, Gd, Gd, Gd, Gd, Gd, Gd^Es, Gd^Es
Hhd^Fms, Hhd^Fms, Gs^Fms, Gs^Fdf, Hhd^Fmf, Hhd^Fdf, Mm, Hhd^Fdf, Mm, Hhd, Mm, Hhd, Hhd^Fdf, Gs^Fdf, Gs^Fdf, Gd, Hhd^Fdf, Hhd^Fms, Gs^Fms, Hhd^Fms, Hhd^Fmf, Gd, Gd, Gd, Gd, Gd^Es, Gd, Gd, Gd, Gd, Gd, Gd, Gd, Gd, Gd
Wwg, Hhd^Fms, Gd, Hhd^Fms, Hhd^Fms, Hhd^Fms, Hhd^Fms, Hhd, Mm, Mm, Gs^Fds, Mm, Hhd^Fms, Hhd^Fdf, Gs^Fdf, Gs^Fdf, Gs^Fdf, Gs^Fdf, Gll, Hhd^Fms, Gs^Fms, Gd, Gd, Gd, Gd, Gd, Gd, Gd, Gd, Gd^Es, Gd, Gd, Gd, Gd, Gd
