Gll^Fdf, Gll^Fdf, Gll^Fdf, Gll^Fdf, Gll^Fdf, Gll^Fdf, Wwf, Wwf, Gll^Fdf, Gll^Fdf, Gll^Fdf, Gll^Fdf, Gll^Fdf, Gll^Fdf, Gd, Gd, Gll^Fdf, Gll^Fdf, Gll^Fdf, Gll^Fdf, Gll^Fdf, Gll^Fdf, Gll^Fdf, Gll^Fdf, Gll^Fdf, Gll^Fdf, Gll^Fdf, Gll^Fdf, Gll^Fdf, Gll^Fdf, Gll^Fdf, Gll, Gll^Fdf, Gll^Fdf, Gll^Fdf, Gd, Hhd, Ds, Hhd, Hhd^Fdf, Hhd, Md, Hhd^Fdf, Gll^Fdf, Md, Md, Md, Md, Md, Md, Md, Md
Gd, Gll^Fdf, Gll^Fmf, Gll^Fdf, Gll^Fmf, Gll^Fdf, Wwf, Wwf, Ds, Ds, Ds, Gll^Fdf, Gd, Gd, Gd^Efm, Gll^Fdf, Gll^Fmf, Gll^Fmf, Gd, Gd, Gll^Fmf, Gll^Fmf, Gll^Fmf, Gll^Fmf, Gll^Fmf, Gll^Fmf, Gll^Fmf, Gll^Fdf, Gll^Fms, Gll^Fdf, Gll^Fms, Gll^Fdf, Gll^Fms, Gll^Fdf, Gll^Fdf, Gll^Fdf, Gll^Fdf, Hhd, Ds, Hhd^Fms, Hhd^Fdf, Hhd^Fdf, Hhd^Fdf, Gll^Fdf, Md, Md, Md, Md, Md, Md, Md, Md
Gd, Gd, Gd, Gll^Fmf, Ds, Gll^Fdf, Wwf, Wwf, Wwf, Ds, Ds, Ds, Gd, Gd^Es, Gd^Es, Gd^Efm, Gd^Efm, Gd^Efm, Gd^Es, Gd, Gll^Fdf, Gll^Fmf, Gll^Fmf, Gll^Fmf, Gll, Gll, Hhd^Fdf, Gll^Fdf, Gll^Fdf, Gll^Fms, Gll^Fms, Gll^Fms, Gll^Fms, Gll^Fdf, Gll^Fms, Gll^Fdf, Gll^Fdf, Ds, Gll^Fdf, Ds, Gll^Fdf, Gll^Fdf, Gll^Fdf, Gll^Fdf, Gll^Fdf, Md, Md, Md, Md, Md, Md, Md
Gd, Gd, Gd, Gll^Fmf, Gll^Fdf, Ds, Gll^Fdf, Wwf, Wwf, Wwf, Wwf, Ds, Ds, Gd, Gll^Fdf, Gd, Gll^Fdf, Gd^Es, Hhd^Fdf, Gll^Fdf, Hhd^Fdf, Hhd^Fdf, Ds, Gll, Gd^Es, Gd, Gll, Gd, Ds, Gll^Fmf, Gll^Fmf, Gll^Fmf, Gll^Fms, Gll^Fdf, Gll^Fmf, Gll^Fdf, Gd, Gd, Gll^Fdf, Gll^Fmf, Gll^Fmf, Gll^Fmf, Gll^Fmf, Gll^Fdf, Hhd, Gll^Fdf, Md, Md, Md, Md, Md, Md
Gll^Fmf, Gll^Fdf, Gd, Gd, Gd, Ds, Ds, Ds, Wwf, Wwf, Wwf, Ds, Gd, Gd, Hhd^Fms, Gll^Fdf, Hhd^Fms, Gll^Fdf, Gll^Fdf, Hhd^Fdf, Md, Md, Md^Xm, Ds, Gd^Es, Gd, Gd, Gd^Efm, Ds^Esd, Hhd, Ds, Gd^Edt, Gd^Edt, Gll^Fmf, Hhd, Hhd, Hhd, Gd, Gll^Fdf, Gll^Fmf, Gll^Fmf, Gll^Fms, Hhd^Fms, Hhd^Fdf, Hhd^Fdf, Gll^Fdf, Md, Md, Md, Md, Gll^Fdf, Gll^Fdf
Gll^Fdf, Gll^Fmf, Gll^Fdf, Gd^Es, Gd^Efm, Gd^Efm, Ds, Ds, Ds, Wwf, Wwf, Wwf, Wwf, Gd, Wwf, Hhd^Fms, Gll^Fdf, Gll^Fdf, Hhd^Fdf, Md, Md, Md, Md, Hhd^Fdf, Ds, Gll, Gd^Efm, Ds, Ds, Ds, Ds, Gll^Fdf, Hhd, Ds, Hhd, Hhd, Gd^Efm, Gd^Efm, Gll^Fmf, Gll^Fdf, Gll^Fmf, Ds, Hhd, Gd^Vhr, Hhd^Fdf, Gll^Fmf, Gll^Fdf, Md, Gll^Fdf, Gll^Fdf, Gll^Fdf, Gll^Fdf
Gll^Fdf, Gll^Fmf, Gd, Gd, Gd^Efm, Gd^Efm, Gd, Ds, Ds, Ds, Ds, Ds, Wwf, Wwf, Wwf, Wwf, Ds, Gll^Fmf, Gll^Fdf, Hhd^Fdf, Md, Md, Md, Hhd^Fdf, Hhd^Fdf, Gd^Efm, Gd, Ds, Gd, Gd, Ds, Ds, Ds, Ds, Ds, Hhd, Hhd, Gd^Efm, Gd^Efm, Gll^Fdf, Gll^Fmf, Hhd, Gd^Es, Gd, Gd, Gll^Fmf, Gll^Fmf, Gll^Fdf, Gll^Fdf, Gll^Fdf, Gll^Fdf, Gll^Fdf
Gd, Gd, Gd, Gll^Fdf, Gd^Efm, Gd^Efm, Gd^Efm, Ds, Gd, Ds, Gll^Fmf, Gll^Fdf, Wwf, Wwf, Wwg, Wwf, Ds, Gd^Efm, Gll^Fmf, Hhd^Fms, Hhd^Fms, Hhd^Fms, Md, Hhd^Fdf, Gll^Fdf, Hhd, Gd^Efm, Gd, Ds, Ds, Ds, Ds, Ds, Ds, Ds, Gd^Edt, Gd^Efm, Gd^Efm, Gll^Fmf, Gll^Fdf, Gd^Vhr, Ds, Ds, Gd^Es, Ce, Gd, Gd^Efm, Gll^Fmf, Gll^Fdf, Gll^Fdf, Gd, Gd
Gll^Fdf, Gll^Fdf, Gll^Fmf, Gll^Fdf, Gd^Es, Gd^Es, Gd, Gd^Efm, Gd, Gll^Fmf, Gll^Fmf, Gll^Fdf, Gll^Fdf, Hhd, Wwf, Wwf, Ds, Gd, Ds, Hhd^Fms, Ds, Hhd^Fdf, Hhd^Fdf, Gd^Em, Gll^Fdf, Hhd, Gd, Gd^Efm, Ds, Ds, Gd^Es, Ds, Ds, Ds, Ds, Gd^Efm, Gd^Efm, Gd^Efm, Gll^Fmf, Gll^Fmf, Ds, Ds, Gd^Es, Ce, 3 Ket, Ce, Gd, Gd, Gll^Fdf, Gll^Fdf, Gd, Gd
Gll^Fdf, Gll^Fdf, Gll^Fmf, Gd, Gll^Fdf, Gll^Fdf, Gll^Fdf, Gll^Fdf, Hhd^Fdf, Hhd^Fdf, Md, Gll^Fdf, Hhd, Gd, Wwf, Wwf, Wwf, Ds, Ds^Esd, Ds, Hhd, Hhd^Fms, Gd, Hhd^Fdf, Gd^Vct, Gd, Gd, Hhd, Gd, Hhd, Gd^Es, Ds, Hhd, Ds, Ds, Ds, Gd, Gd^Es, Gd, Ds, Ds, Gd^Es, Gd, Ce, Ce, Ce, Gd, Gd^Es, Gd, Gd, Gd, Gd
Gll^Fmf, Gll^Fmf, Gd, Gd, Gll^Fdf, Hhd^Fdf, Hhd^Fdf, Hhd^Fdf, Md, Md, Md, Gll^Fdf, Gd^Dr, Gd, Ds, Wwf, Wwf, Wwf, Ds, Ds^Esd, Gd, Gd, Gd, Gd, Gll, Gd, Gd^Vct, Gd, Gd, Ds, Ds, Ds, Ds, Ds, Ds, Gd, Gd, Gd, Gd^Es, Gd^Es, Ds, Ds, Ds, Gd, Gd^Efm, Gd, Gd^Efm, Gd^Es, Gd, Gd, Gd^Vhr, Gd
Gll^Fdf, Gd^Es, Gd, Gll^Fdf, Hhd^Fdf, Hhd^Fdf, Hhd^Fdf, Md, Hhd^Fdf, Md, Md, Gll^Fmf, Hhd, Ds, Wwf, Wwf, Wwf, Wwf, Wwf, Ds, Gd, Gd^Vct, Ce, Ce, Ce, Gd, Gd, Gd, Gd, Gd, Gd, Ds, Hhd, Ds, Hhd, Gd, Hhd, Gd^Es, Hhd, Gd^Es, Hhd, Hhd, Ds, Gd, Gd, Ds^Es, Ds, Gd^Efm, Ds, Gd^Es, Gd, Gd^Es
Gll^Fdf, Gll^Fdf, Gd^Efm, Gd^Efm, Gd, Hhd^Fdf, Gs^Fms, Gll^Fmf, Hhd, Hhd, Gd^Efm, Gll^Edb, Gd, Ds^Esd, Ds, Wwf, Wwf, Ds, Ds, Ds, Ds, Gd, Ce, 2 Ke, Ce, 1 Gd, Gd^Ecf, Gd, Gd, Gd, Gd, Hhd, Gll^Fdf, Hhd, Hhd, Gd, Gd, Gd^Es, Hhd^Fdf, Gll^Fmf, Gll^Fdf, Hhd, Ds, Ds^Esd, Ds^Es, Ds, Ds, Ds^Es, Hhd^Fdf, Ds, Ds, Hhd^Fdf
Gd, Gd^Es, Gd, Gd^Efm, Gll^Fdf, Gd^Dr, Gs^Fms, Hhd^Fdf, Hhd^Fdf, Gll^Fmf, Gd^Efm, Gd^Efm, Gd^Efm, Gd, Gd, Wwf, Wwf, Wwf, Ds^Esd, Ds^Esd, Ds, Ds, Gd^Vct, Ce, Gd, Gd, Gd, Gd, Gd^Vct, Gd, Gd, Hhd^Fdf, Hhd^Fdf, Gll^Fdf, Hhd, Gd^Efm, Gd, Hhd^Fdf, Gd, Gll^Fdf, Gll^Fdf, Gd^Fms, Ds, Ds^Es, Md, Hhd, Md, Gll^Fdf, Hhd^Fdf, Hhd^Fdf, Hhd^Fdf, Ds
Gll^Fdf, Gll^Fdf, Gd, Gd, Gd, Gs^Fms, Gd, Hhd, Gll^Fmf, Gd, Gd^Efm, Gd^Efm, Gd^Es, Gd^Efm, Ds, Ds, Wwf, Wwf, Ds, Ds^Esd, Ds, Gd^Efm, Gll, Gd^Efm, Gd^Efm, Gd, Gd, Gd, Gd, Gd, Gd, Hhd^Fdf, Gd, Hhd, Gd^Efm, Gd, Hhd^Fdf, Hhd^Fms, Gll^Fmf, Gll^Fmf, Gll^Fdf, Gll^Fdf, Ds, Hhd, Md, Md, Md, Hhd^Fms, Hhd^Fms, Hhd^Fms, Hhd^Fms, Hhd^Fms
Gll^Fdf, Gll^Fdf, Gd^Es, Gd^Es, Hhd, Hhd^Fms, Hhd^Fms, Gll^Fmf, Hhd, Gs, Gd^Efm, Gd^Es, Gd^Efm, Gd, Ds, Ds^Esd, Wwf, Wwf, Wwf, Wwf, Wwf, Hhd^Fdf, Wwf, Gd^Efm, Gd, Gll^Fmf, Hhd^Fms, Hhd^Fdf, Hhd, Hhd^Fdf, Gll^Fdf, Gd^Es, Gd, Gd, Gd^Efm, Gd^Efm, Gd, Gs^Fms, Gll^Fmf, Hhd, Hhd^Fdf, Ds, Ds, Hhd, Hhd, Md, Md, Hhd^Fms, Md, Md, Md, Md
Gll^Fdf, Gd^Es, Gd, Gd, Gd^Es, Hhd, Hhd^Fms, Gs^Fms, Gd^Es, Hhd, Gd, Gd, Gd, Ds, Gd^Dr, Wwf, Wwf, Wwf, Wwf, Wwf, Hhd, Wwf, Wwf, Gd, Gd, Hhd^Fdf, Gll^Fmf, Hhd^Fdf, Gll^Fdf, Hhd^Fdf, Hhd, Gd^Efm, Gd, Gd^Es, Gd, Gd^Efm, Gd, Gll^Fmf, Gll^Fdf, Gd^Vhr, Hhd^Fdf, Ds, Ds, Ds, Hhd^Fdf, Hhd, Hhd^Fdf, Md, Md, Md, Md, Md
Gll^Fdf, Gll^Fmf, Gll^Fmf, Gd, Gd, Hhd, Hhd^Fms, Gll^Fdf, Gs^Fms, Hhd, Hhd, Gd, Gd, Ds, Wwf, Wwf, Wwf, Wwf, Gd, Gd^Es, Gd, Gd, Gd, Wwf, Hhd, Gd^Vhr, Hhd^Fdf, Gd, Gll^Fmf, Gll^Fmf, Gll^Fmf, Gd, Gd^Efm, Gd^Es, Gd^Es, Gd, Gd, Gd, Ds, Hhd, Hhd, Hhd^Fdf, Ds, Ds, Hhd^Fms, Hhd^Fms, Hhd^Fdf, Hhd^Fdf, Hhd^Fdf, Gll^Fdf, Hhd^Fdf, Gll^Fdf
Gll^Fdf, Gll^Fmf, Gll^Fmf, Gd, Gd^Es, Gd, Gll^Fdf, Gll^Fdf, Gll^Fdf, Gs^Fms, Hhd, Ds, Ds, Ds, Ds, Wwf, Wwf, Ds, Ds, Hhd, Gd, Gd^Es, Gd^Es, Wwf, Wwf, Ds, Ds^Esd, Ds, Ds, Ds, Ds, Gll^Fmf, Gd^Es, Gd, Gd, Gd^Efm, Gd^Efm, Ds, Ds, Ds, Hhd, Hhd, Hhd, Gll^Fmf, Md, Hhd^Fdf, Gll^Fmf, Gll^Fdf, Gll^Fdf, Hhd^Fdf, Ds, Gll^Fdf
Gll^Fdf, Gll^Fdf, Gll^Fdf, Gll^Fdf, Gd^Es, Gd^Es, Gd, Gll^Fmf, Hhd, Hhd, Ds, Ds, Ds, Ds, Ds, Wwf, Wwf, Ds, Gll^Fdf, Gd, Gll^Fdf, Gll^Fdf, Gll^Fdf, Gd^Efm, Wwf, Wwf, Wwf, Ds, Wwf, Ds^Esd, Ds, Gd, Gd^Efm, Gd, Gll^Fmf, Gd, Gd, Gd, Hhd, Hhd, Hhd, Hhd, Hhd, Hhd, Ds, Gll^Fmf, Ds, Gll^Fdf, Ds, Ds, Ds, Ds
Gll^Fdf, Gll^Fdf, Gd^Efm, Gll^Fdf, Gd^Efm, Gd, Gd^Efm, Ds, Ds, Gd^Vhr, Ds, Ds, Hhd, Ds, Gd, Wwf, Wwf, Wwf, Wwf, Gd, Ds, Gll^Fmf, Gd^Efm, Gd^Efm, Hhd, Ds, Ds, Wwf, Wwf, Wwf, Ds^Esd, Ds, Gd, Gll, Gll, Gd^Vhr, Gll^Fp, Gd, Gd, Ds, Ds, Hhd, Hhd, Ds, Ds, Ds, Ds, Ds, Hhd, Ds, Ds, Ds
Gll^Fdf, Gll^Fdf, Gd^Vhr, Gd^Efm, Gd^Efm, Gd^Efm, Ce, Gd, Gd, Ds, Gd, Hhd^Fms, Gd, Gd, Gd, Ds, Wwf, Wwf, Wwf, Ds, Ds, Gd, Gd^Vhr, Gd^Dr, Hhd, Ds^Esd, Ds, Ds, Ds, Wwf, Ds^Esd, Ds, Ds, Gd, Gd^Es, Gll^Fmf, Ds, Gd, Gd, Ds, Gd, Gd, Hhd, Hhd, Ds, Hhd, Hhd, Hhd, Hhd, Ds, Hhd, Hhd
Gll^Fdf, Gll^Fdf, Gd^Es, Gd^Es, Gd^Efm, Ce, 4 Ket, Ce, Gd, Gd, Gd, Gd, Hhd, Gd, Hhd, Ds, Ds^Esd, Wwf, Wwf, Wwf, Wwf, Ds, Gd, Gll^Fdf, Hhd^Fdf, Hhd, Gd, Gd, Ds, Wwf, Wwf, Gd, Gd^Efm, Gd, Ds, Gll^Fmf, Hhd, Ds, Gd^Vhr, Gd, Gd, Gd, Gd, Ds, Ds, Ds, Hhd, Ds, Ds, Hhd, Hhd, Hhd
Gll^Fdf, Gll^Fmf, Gll^Fmf, Gd^Es, Gd^Es, Ce, Ce, Ce, Gll^Fdf, Hhd^Fms, Hhd^Fms, Hhd^Fms, Hhd, Md, Gd^Vhr, Ds, Gd^Es, Ds, Ds^Esd, Wwf, Wwf, Ds, Gd, Gll^Fdf, Gll^Fdf, Hhd^Fdf, Gd, Gd^Efm, Gd^Es, Wwf, Ds, Wwf, Wwf, Gd, Ds, Ds, Ds, Ds, Ds, Ds, Gd, Gd^Efm, Gd^Efm, Gd, Ds, Ds, Ds, Gd, Ds, Ds, Ds, Ds
Gll^Fdf, Gll^Fdf, Gll^Fmf, Gs^Fms, Gs^Fms, Gd^Es, Gd^Efm, Gd, Gll^Fmf, Hhd^Fms, Gll^Fdf, Gll^Fdf, Gll^Fdf, Hhd, Hhd, Gll, Gd^Efm, Ds, Ds, Wwf, Wwf, Wwf, Gll^Fdf, Gd^Efm, Gll^Fdf, Hhd^Fdf, Gd, Gd^Efm, Wwf, Wwf, Ds, Ds, Gll^Em, Wwf, Ds, Ds, Hhd, Ds, Hhd, Hhd, Gd, Gd, Gd, Gd^Efm, Gd, Ds, Gd, Gd, Ds, Ds, Ds, Ds
Gll^Fdf, Gll^Fdf, Gll^Fmf, Gs^Fms, Gll^Fdf, Gd^Efm, Gd^Efm, Gll^Fmf, Gll^Fdf, Gs^Fms, Gll^Fdf, Gll^Fmf, Gll^Fmf, Ds, Ds, Gll^Fdf, Gll^Fdf, Gd, Ds, Wwf, Wwf, Wwf, Gd, Gd^Es, Gd, Gll^Fdf, Gll^Fdf, Gd, Gd, Wwf, Wwf, Ds, Ds, Wwf, Wwf, Ds, Ds, Ds, Hhd, Hhd, Hhd, Gd, Gd, Gd^Efm, Gd, Gd, Gd, Gd, Ds, Ds, Ds, Ds
Gll^Fdf, Gll^Fmf, Gll^Fdf, Gll^Fdf, Gll^Fdf, Gll^Fdf, Gll^Fdf, Gll^Fmf, Gd^Es, Gll^Fmf, Gs^Fms, Gs^Fms, Wwf, Ds, Wwf, Ds, Gll^Fdf, Hhd^Fms, Wwf, Wwf, Wwf, Ds, Ds, Ds, Ds, Ds, Ds, Gll^Fdf, Gll, Gd^Es, Wwf, Ds, Ds, Ds, Wwf, Wwf, Wwf, Ds, Wwf, Ds, Ds, Ds, Gd, Ds, Ds, Gd^Efm, Gd^Efm, Ds, Ds, Ds, Hhd, Hhd
Gll^Fdf, Gll^Fdf, Gll^Fdf, Gll^Fdf, Gll^Fdf, Gll^Fdf, Gll^Fdf, Gd^Es, Gll^Fdf, Gll^Fdf, Gll^Fdf, Gll^Fdf, Gll^Fdf, Wwf, Wwf, Wwf, Wwf, Wwf, Wwf, Wwf, Wwf, Ds, Ds, Gd^Es, Ds, Gs^Fms, Ds, Gll^Fdf, Gd, Wwf, Wwf, Ds, Ds, Ds, Ds, Gll^Fmf, Wwf, Wwf, Ds, Ds, Ds, Ds, Ds, Ds, Ds, Gd, Gll^Fdf, Gd, Ds, Ds, Ds, Hhd
