Mdd, Mdd, Mdd, Mdd, Mdd, Xu, Xu, Xu, Xu, Xu, Xu, Xu, Xu, Xu, Xu, Gg, Xu, Gg, Xu, Xu, Xu, Xu, Xu, Xu, Xu, Xu, Xu, Xu, Xu, Xu, Xu, Xu, Xu, Xu, Uh^Dr, Rb^Es, Urb, Urb, Rb, Urb, Rb, Rb, Uh^Dr, Xu, Xu, Xu, Xu, Xu, Xu, Xu, Xu, Xu, Xu, Xu, Xu, Xu, Mdd, Gd, Mdd, Mdd, Mdd, Mdd, Mdd, Gd, Mdd, Hhd, Hhd, Gd, Gd
Mdd, Mdd, Mdd, Mdd, Mdd, Xu, Xu, Xu, Xu, Xu, Xu, Xu, Xu, Xu, Xu, Xu, Xu, Xu, Xu, Xu, Xu, Xu, Xu, Xu, Xu, Xu, Xu, Xu, Xu, Xu, Xu, Xu, Xu, Xu, Xu, Xu, Urb, Rb, Rb, Rb, Urb, Uh, Uu^Vu, Xu, Xu, Xu, Xu, Xu, Xu, Xu, Xu, Xu, Xu, Xu, Xu, Xu, Mdd, Mdd, Mdd, Mdd, Mdd, Mdd, Mdd, Mdd, Hhd, Hhd, Gd, Hhd, Gd
Mdd, Mdd, Mdd, Mdd, Mdd, Xu, Xu, Xu, Xu, Xu, Xu, Xu, Xu, Xu, Xu, Xu, Xu, Xu, Xu, Xu, Xu, Xu, Xu, Xu, Xu, Xu, Xu, Xu, Xu, Xu, Xu, Xu, Xu, Xu, Xu, Xu, Uu^Uf, Rb, Rb, Rb, Uh^Dr, Rb^Uf, Xu, Xu, Xu, Xu, Xu, Xu, Xu, Xu, Xu, Xu, Xu, Xu, Xu, Xu, Mdd, Mdd, Mdd, Mdd, Hhd, Hhd^Ftd, Hhd^Ftd, Hhd, Hhd, Hhd, Hhd, Hhd, Gd
Mdd, Mdd, Mdd, Mdd, Mdd, Mdd, Xu, Xu, Xu, Xu, Xu, Xu, Xu, Xu, Xu, Mdd, Mdd, Mdd, Mdd, Xu, Mdd, Mdd, Mdd, Xu, Xu, Xu, Xu, Xu, Xu, Xu, Xu, Xu, Xu, Xu, Xu, Uu^Uf, Urb^Vu, Urb, Xu, Urb, Cty, Uh^Uf, Uh^Uf, Xu, Xu, Xu, Xu, Xu, Xu, Xu, Xu, Xu, Xu, Xu, Xu, Mdd, Mdd, Mdd, Hhd^Ftd, Mdd, Hhd^Ftd, Hhd^Ftd, Hhd, Hhd, Hhd, Hhd, Dd, Ds, Dd
Mdd, Mdd, Mdd, Mdd, Mdd, Mdd, Mdd, Xu, Xu, Xu, Xu, Xu, Xu, Xu, Mdd, Mdd, Mdd, Mdd, Mdd, Mdd, Hhd, Mdd, Mdd^Xm, Xu, Mdd^Xm, Xu, Xu, Xu, Xu, Xu, Xu, Xu, Xu, Xu, Xu, Xu, Xu, Urb, Urb, Cty, 2 Cty^Kov, Cty, Uh^Uf, Xu, Xu, Xu, Xu, Xu, Xu, Xu, Xu, Xu, Xu, Xu, Mdd, Mdd, Mdd, Hhd, Hhd^Ftd, Hhd^Ftd, Ds^Ftd, Hhd^Ftd, Hhd, Hhd, Dd^Ftd, Dd^Ftd, Dd, Dd, Ds
Hhd, Mdd, Mdd, Hhd, Hhd, Mdd, Mdd, Mdd, Mdd, Xu, Mdd, Xu, Xu, Xu, Mdd, Mdd, Mdd, Hhd, Hhd^Fts, Hhd, Hhd^Fts, Mdd^Xm, Mdd^Xm, Mdd^Xm, Xu, Xu, Xu, Xu, Xu, Xu, Xu, Xu, Xu, Xu, Cud, Uh^Dr, Rb^Es, Uu^Dr, Urb, Cty, Cty, Cty, Uh^Dr, Xu, Xu, Xu, Xu, Xu, Xu, Xu, Mdd, Xu, Mdd, Mdd, Mdd, Mdd, Mdd, Mdd, Ds, Hhd^Ftd, Hhd, Dd, Hhd, Dd^Ftd, Dd, Dd, Dd, Ds, Ds
Ds^Fdf, Hhd, Ds^Fdf, Hhd^Fdf, Hhd, Hhd, Hhd, Mdd, Mdd, Mdd, Mdd, Mdd, Mdd, Mdd, Mdd, Mdd, Hhd, Hhd^Fts, Hhd^Fts, Hhd^Fts, Hhd^Fts, Hhd, Mdd^Xm, Mdd^Xm, Xu, Xu, Xu, Xu, Xu, Xu, Xu, Xu, Xu, Xu, Cud, Urb, Urb, Urb, Urb, Urb, Urb, Uh^Dr, Cud, Xu, Xu, Xu, Xu, Xu, Xu, Mdd, Mdd, Mdd, Mdd, Mdd, Gd, Hhd, Hhd, Mdd, Dd^Fts, Hhd, Hhd, Hhd, Hhd, Hhd, Dd, Dd, Dd, Dd, Dd
Ds, Ds^Fdf, Ds^Fdf, Hhd^Fdf, Hhd^Fdf, Hhd^Fdf, Hhd^Fdf, Mdd, Hhd, Hhd, Mdd, Mdd, Mdd^Fts, Mdd, Mdd, Mdd, Hhd, Hhd^Fts, Hhd^Fts, Hhd, Hhd^Fts, Mdd, Mdd, Mdd^Xm, Mdd, Xu, Xu, Xu, Xu, Xu, Xu, Xu, Xu, Xu, Xu, Uu^Vu, Urb, Urb, Urb, Urb, Urb^Vu, Uh^Dr, Cud, Cud, Xu, Xu, Xu, Xu, Mdd, Mdd, Mdd, Mdd, Gd, Mdd, Mdd, Hhd, Hhd, Dd^Fts, Dd^Fts, Dd, Dd^Fts, Ds, Ds, Hhd, Dd, Dd, Ds, Dd, Dd
Ds, Ds, Ds^Fdf, Hhd^Fdf, Hhd^Ftd, Gll^Fdf, Ds^Fdf, Hhd^Fdf, Mdd, Mdd, Gll^Fts, Mdd^Fts, Mdd^Fts, Mdd^Fts, Mdd, Hhd, Mdd, Hhd^Fts, Hhd^Fts, Hhd^Fts, Hhd^Fts, Mdd, Mdd, Mdd^Xm, Xu, Xu, Xu, Xu, Xu, Xu, Xu, Xu, Xu, Xu, Xu, Xu, Uh, Rb^Es, Urb, Urb, Urb, Cud, Uh^Dr, Xu, Xu, Xu, Xu, Xu, Dd^Fts, Mdd, Hhd, Hhd, Hhd, Mdd, Hhd, Hhd, Hhd, Ds, Dd, Dd^Fts, Rd, Dd, Dd, Dd, Dd, Dd, Rd, Rd, Rd
Gd, Ds, Gd, Ds^Fdf, Ds^Fts, Gll^Fdf, Ds^Fts, Ds^Fdf, Ds^Fts, Ds^Fts, Ds^Fts, Gll^Fts, Mdd, Mdd^Xm, Mdd^Xm, Mdd^Xm, Hhd, Hhd^Fts, Ds^Fts, Ds, Ds^Fts, Mdd, Hhd, Xu, Xu, Xu, Mdd^Ftd, Ds^Fts, Re, Xu, Cud, Uh^Dr, Uh^Dr, Xu, Cud, Xu, Rb^Es, Urb, Urb, Urb, Xu, Xu, Xu, Xu, Xu, Xu, Hhd^Vhhr, Xu, Dd^Fts, Dd^Fts, Dd^Fts, Dd^Fts, Hhd, Hhd, Ds, Hhd, Dd, Dd, Dd, Dd, Rd, Rd, Rd, Rd, Rd, Rd, Ds, Rd, Dd
Rd, Rd, 3 Ds, Ds, Ds^Fts, Ds^Fts, Ds^Fts, Ds^Fts, Ds^Fts, Gll^Fts, Hhd, Mdd, Mdd, Mdd, Mdd^Xm, Mdd^Xm, Mdd^Xm, Hhd^Fts, Gll^Fts, Ds, Ds^Fts, Gll^Fts, Mdd, Mdd^Xm, Mdd, Xu, Hhd, Ds^Fts, Ds, Re, Xu, Uh^Dr, Xu, Cud, Uh^Dr, Uu^Dr, Urb, Rb, Urb, Urb^Vu, Uu^Dr, Xu, Cud, Xu, Uh^Dr, Xu, Xu, Hhd, Dd^Fts, Dd^Fts, Ds, Dd^Fts, Dd, Ds, Ds, Dd, Dd, Dd, Dd^Fts, Ds, Rd, Dd^Fts, Ds, Ds, Ds, Dd, Dd, Dd, Ds
Gd, Rd, Rd, Ds^Es, Gd, Ds, Gd, Ds^Es, Gd, Hhd, Gll^Fts, Gll^Fts, Mdd, Mdd, Mdd, Mdd^Xm, Hhd, Hhd^Fts, Hhd^Fts, Ds, Ds, Dd^Fts, Dd^Fts, Hhd, Mdd, Ds^Fts, Ds^Fts, Ds^Efm, Ds^Edb, Re, Re, Rb, Uu^Dr, Xu, Rb, Rb, Rd, Urb, Ds^Es, Urb, Urb, Urb, Xu, Uh^Dr, Xu, Cud, Re, Rd, Dd, Dd, Dd, Dd, Rd, Ds, Dd, Dd, Dd, Dd^Fts, Ds, Dd^Fts, Rd, Rd, Ds, Ds, Dd, Dd, Dd^Fts, Dd, Dd
Gll^Fts, Gll^Fts, Gd, Rd, Rd, Rd, Rd, Rd, Rd, Gll^Fts, Ds^Fts, Hhd, Hhd^Fts, Hhd, Hhd^Fts, Mdd^Xm, Hhd, Hhd^Fts, Hhd^Fts, Gll, Ds, Ds, Ds^Fts, Mdd, Ds, Ds^Fts, Dd, Dd, Dd, Ds, Rd, Re, Ds, Rb, Rd, Rd, Uu^Dr, Rd, Ds^Es, Ds, Urb, Urb, Urb, Uh^Dr, Xu, Xu, Rd, Dd, Dd, Ds, Dd, Rd, Ds, Dd, Ds, Ds, Ds, Ds, Rd, Rd, Rd, Ds, Dd^Fts, Dd^Fts, Dd^Fts, Dd^Fts, Dd^Fts, Dd, Re
Ds, Ds, Ds, Ds, Ds, Ds, Gd, Rd, Gd, Rd, Ds^Em, Gll^Fts, Ds^Fts, Hhd^Fts, Hhd^Fts, Hhd, Hhd^Fts, Hhd^Fts, Hhd^Fts, Ds^Fts, Ds^Fts, Ds, Ds, Ds, Ds, Ds, Hhd, Dd, Dd, Rd, Ds, Rd, Rd, Rd, Xu, Uh^Dr, Xu, Urb, Uu^Dr, Ds, Urb, Urb, Urb, Rb, Hhd, Re, Ds, Re, Ds, Dd, Rd, Rd, Rd, Dd, Dd, Dd, Rd, Rd, Rd, Dd^Fts, Dd, Dd, Dd^Fts, Dd, Dd^Fts, Dd^Fts, Hhd, Hhd, Hhd
Wwg, Wwg, Wwg, Ds, Wwg, Ds, Ds, Gd, Gd, Gll, Gd, Ds^Fts, Ds^Fdf, Gll^Fdf, Hhd^Fdf, Hhd^Fts, Hhd^Fts, Hhd^Fts, Hhd^Fts, Gll^Fts, Gd, Gd^Efm, Ds, Dd, Dd, Dd, Ds, Hhd, Dd, Rd, Rd, Ds, Re, Xu, Xu, Urb^Vu, Uh^Dr, Xu, Urb, Urb, Urb, Urb, Ds, Rb, Ds, Rb, Ds, Re, Re, Dd, Rd, Rd, Dd^Es, Rd, Rd, Rd, Dd, Rd, Dd, Ds, Hhd^Ftd, Dd, Dd^Fts, Hhd, Hhd^Ftd, Hhd, Hhd^Ftd, Hhd, Hhd
Wwg, Wwg, Wwg, Wwg, Wwg, Ds, Ds, Gd, Gd^Es, Gll, Ds, Ds, Ds, Ds^Fdf, Gd, Gll^Fts, Gll^Fdf, Gll^Fts, Gll^Fts, Gd, Gd^Efm, Gd^Efm, Ds, Ds, Dd, Dd, Dd, Ds, Rd, Rd, Re, Re, Dd, Xu, Cud, Xu, Uh^Dr, Xu, Uu^Dr, Urb, Ds, Urb, Xu, Ds, Ds, Ds, Ds, Re, Dd, Dd, Re, Rd, Dd^Fts, Dd, Dd, Ds, Dd, Dd, Dd, Hhd, Hhd^Ftd, Hhd, Hhd^Ftd, Hhd^Ftd, Hhd^Ftd, Hhd^Ftd, Mdd^Ftd, Hhd, Hhd
Gll^Fmw, Ds, Wwf, Wwg, Wwg, Wwg, Wwg, Gd, Wwg, Ds, Ds, Ds, Hhd, Gd, Gd, Gll^Fdf, Gd, Gd^Es, Gll, Gd, Gd, Gd, Ds, Ds, Rd, Rd, Rd, Dd, Dd, Dd, Dd, Hhd, Dd, Re, Xu, Xu, Xu, Cud, Urb, Urb, Urb, Urb^Vu, Cud, Rb, Xu, Re, Dd, Dd, Dd, Re, Gll^Fts, Dd^Fts, Dd^Fts, Dd^Fts, Dd^Fts, Ds^Ftd, Hhd, Hhd, Hhd, Hhd, Mdd, Hhd^Ftd, Mdd^Ftd, Hhd^Ftd, Mdd^Ftd, Mdd^Ftd, Mdd, Gd, Hhd
Ds^Fdf, Ds, Ds, Wwg, Wwg, Wwg, Wwg, Wwg, Wwg, Ds, Ds, Ds^Fdf, Hhd, Gd, Gd^Efm, Gll, Gd, Gd, Gd, Ds, Hhd, Ds, Hhd, Hhd, Gd, Ds^Es, Ds, Rd, Rd, Ds, Dd, Dd, Re, Ds, Ds, Xu, Rb, Urb, Urb, Urb, Xu, Xu, Xu, Uh^Dr, Xu, Xu, Uh^Dr, Dd, Ds, Re, Dd^Fts, Dd^Fts, Mdd^Ftd, Mdd^Ftd, Mdd^Ftd, Mdd, Mdd, Mdd, Mdd, Hhd, Mdd^Ftd, Mdd, Mdd^Ftd, Mdd^Ftd, Mdd^Ftd, Mdd^Ftd, Hhd, Hhd, Hhd
Ds^Ftd, Ds^Fdf, Ds^Ftd, Ds, Ds, Wwg, Wwg, Ds, Ds, Wwg, Hhd, Gll^Fdf, Hhd, Gd, Gll, Gd, Gd, Gd, Ds, Ds, Gll, Ds, Hhd, Hhd, Hhd, Gd^Efm, Gd, Ds, Rd, Dd, Rd^Es, Hhd, Ds^Es, Ds, Rd, Re, Rb, Uu^Dr, Xu, Uh^Dr, Cud, Xu, Xu, Cud, Cud, Uh^Dr, Xu, Xu, Xu, Hhd, Mdd, Mdd^Ftd, Mdd, Mdd, Xu, Mdd, Xu, Mdd, Mdd, Mdd^Ftd, Mdd^Ftd, Mdd^Ftd, Mdd^Ftd, Mdd^Ftd, Hhd, Mdd, Hhd, Hhd, Gd
Ds^Ftd, Ds^Ftd, Ds^Ftd, Ds^Ftd, Ds^Ftd, Wwg, Ds^Ftd, Ds^Ftd, Ds, Wwf, Wwf, Wwf, Gd, Gll, Wwf, Gd, Hhd, Rd, Ds, Hhd, Hhd, Hhd, Hhd, Hhd, Gd, Gd, Dd, Ds^Efm, Rd^Edb, Rd^Efm, Rd, Rd, Rd^Es, Dd, Rd, Rd, Ds, Urb, Xu, Uh^Dr, Uh^Dr, Xu, Xu, Xu, Xu, Xu, Xu, Xu, Xu, Hhd^Vhhr, Xu, Mdd, Xu, Xu, Xu, Xu, Xu, Xu, Mdd, Mdd^Ftd, Mdd^Ftd, Mdd^Ftd, Mdd, Hhd, Hhd, Hhd, Hhd, Hhd, Mdd
Ds^Fdf, Ds^Fdf, Ds, Ds^Ftd, Ds^Em, Ds^Ftd, Ds^Ftd, Ds^Ftd, Hhd, Ds, Ds, Wwf, Wwf, Gd^Efm, Wwf, Wwf, Wwf, Rd, Rd, Hhd, Rd, Ds, Hhd, Hhd, Hhd, Ds, Ds^Efm, Rd, Dd, Rd, Hhd, Dd^Edb, Dd, Rd^Edb, Dd^Edb, Ds, Dd, Rb, Uh^Dr, Cud, Xu, Xu, Xu, Xu, Xu, Xu, Xu, Xu, Xu, Xu, Xu, Xu, Xu, Xu, Xu, Xu, Xu, Xu, Xu, Mdd, Mdd, Mdd, Mdd, Mdd, Mdd, Mdd, Mdd, Hhd, Mdd
Ds^Fdf, Ds^Fdf, Gll^Fdf, Ds^Fdf, Ds^Ftd, Ds^Fdf, Ds^Fdf, Hhd, Ds^Ftd, Ds^Ftd, Ds, Wwf, Gd, Wwf, Ds, Wwf, Wwf, Rd, Rd, Rd, Ds, Rd, Rd, Ds, Hhd, Dd, Ds, Rd, Dd, Dd, Dd, Hhd, Re, Dd^Dr, Dd, Ds, Ds, Xu, Uh^Dr, Cud, Xu, Xu, Xu, Xu, Xu, Xu, Xu, Xu, Xu, Xu, Xu, Xu, Xu, Xu, Xu, Xu, Xu, Xu, Xu, Xu, Xu, Mdd, Mdd, Mdd, Mdd, Mdd, Xu, Mdd, Mdd
Ss, Ds^Fdf, Ds^Fdf, Ds, Ds^Fdf, Ds^Fdf, Ds^Ftd, Ds^Ftd, Ds^Es, Hhd, Rd, Gll, Rd^Vdt, Ds, Rd, Wwf, Wwf, Wwf, Wwf, Wwf, Ds, Rd, Rd, Rd, Rd, Dd, Rd, Rd, Ds, Gd^Es, Hhd, Hhd, Re, Ds, Xu, Xu, Xu, Dd, Xu, Xu, Xu, Xu, Xu, Xu, Xu, Xu, Xu, Xu, Xu, Xu, Xu, Xu, Xu, Xu, Xu, Xu, Xu, Xu, Xu, Xu, Xu, Xu, Mdd, Mdd, Mdd, Xu, Xu, Xu, Mdd
Gll^Fdf, Ds^Fdf, Ds^Fdf, Ds^Fdf, Ds^Es, Ds^Fdf, Ds, Ds^Ftd, Gd, Rd, Rd^Vdt, Rd, Rd, Rd, Ds, Ds, Ds, Ds, Ds, Wwf, Wwf, Ds, Rd, Dd, Dd^Fts, Rd, Dd, Dd, Dd, Gll^Fts, Gll^Fts, Gll^Fts, Re^Ftd, Gll^Fts, Xu, Xu, Xu, Xu, Xu, Xu, Xu, Xu, Xu, Xu, Xu, Xu, Xu, Xu, Xu, Xu, Xu, Xu, Xu, Xu, Xu, Xu, Xu, Xu, Xu, Xu, Xu, Xu, Xu, Mdd, Xu, Xu, Xu, Xu, Mdd
Gd, Gd^Es, Gd, Ds, Ds^Fdf, Ds, Ds, Ds^Vdt, Rd, Rd, Ce, Ce, Ce, Ds, Ds, Ds^Vdt, Ds, Ds, Ds, Wwf, Wwf, Rd, Ds, Ds, Gll^Fts, Ds^Fts, Gd^Es, Ds, Ds, Ds, Ds^Ftd, Gll^Fts, Hhd^Ftd, Gll^Fts, Mdd, Mdd, Xu, Xu, Xu, Xu, Xu, Xu, Xu, Xu, Xu, Xu, Xu, Xu, Xu, Xu, Xu, Xu, Xu, Xu, Xu, Xu, Xu, Xu, Xu, Xu, Xu, Xu, Xu, Xu, Xu, Xu, Xu, Xu, Xu
Gd, Ds^Fdf, Gd, Gd, Gll, Gd, Gll, Gll, Gll, Rd, Ce, 1 Ke, Ce, Ds, Ds^Vdt, Hhd^Fdf, Dd^Fts, Dd^Fts, Ds, Ds, Wwrg, Wwf, Ds, Ds, Gll^Fts, Gd^Fts, Gd, Gd, Hhd, Gll^Fts, Ds^Em, Gll^Fts, Gll^Fts, Mdd^Ftd, Mdd, Mdd, Xu, Xu, Xu, Xu, Xu, Xu, Xu, Xu, Xu, Xu, Xu, Xu, Xu, Xu, Xu, Xu, Xu, Xu, Xu, Xu, Xu, Xu, Xu, Xu, Xu, Xu, Xu, Xu, Xu, Xu, Xu, Xu, Xu
Gd, Gll, Gll, Gll, Gll, Gll, Gll, Rd, Rd, Rd, Gd, Ce, Gd^Es, Ds, Hhd^Fdf, Hhd, Hhd, Dd^Fts, Ds, Dd^Fts, Wwg, Wwg, Ds, Gll^Fdf, Ds, Hhd, Hhd^Ftd, Hhd^Ftd, Hhd^Ftd, Mdd, Mdd, Gll^Fts, Mdd, Hhd^Fts, Gll^Fts, Mdd, Xu, Xu, Xu, Xu, Xu, Xu, Xu, Xu, Xu, Xu, Xu, Xu, Xu, Xu, Xu, Xu, Xu, Xu, Xu, Xu, Xu, Xu, Xu, Xu, Xu, Xu, Xu, Xu, Xu, Xu, Xu, Xu, Xu
Gd, Gd, Gd, Gll, Gll, Gd, Rd, Rd, Ds^Vdt, Ds, Ds^Es, Gd^Es, Gll^Fdf, Hhd^Fdf, Hhd, Hhd, Hhd, Hhd^Fdf, Ds, Wwg, Wwg, Wwg, Wwg, Ds, Gll^Fdf, Hhd, Hhd^Fdf, Hhd^Ftd, Hhd^Fdf, Mdd, Mdd, Mdd, Mdd, Hhd^Fts, Mdd, Mdd, Mdd, Xu, Xu, Xu, Xu, Xu, Xu, Xu, Xu, Xu, Xu, Xu, Xu, Xu, Xu, Xu, Xu, Xu, Xu, Xu, Xu, Xu, Xu, Xu, Xu, Xu, Xu, Xu, Xu, Xu, Xu, Xu, Xu
Gd, Gd, Gd, Ds, Ds^Fdf, Gd, Ds, Ds^Fdf, Ds^Fdf, Ds^Fdf, Ds^Es, Ds, Gll^Fdf, Gll^Fdf, Mdd, Hhd, Hhd, Hhd^Fts, Ds, Ds, Wwg, Wwg, Ds^Fts, Ds^Fts, Ds, Hhd, Mdd, Mdd, Mdd, Mdd, Xu, Mdd, Mdd, Mdd, Mdd, Mdd, Xu, Xu, Xu, Xu, Xu, Xu, Xu, Xu, Xu, Xu, Xu, Xu, Xu, Xu, Xu, Xu, Xu, Xu, Xu, Xu, Xu, Xu, Xu, Xu, Xu, Xu, Xu, Xu, Xu, Xu, Xu, Xu, Xu
Gd, Gd, Ds, Ds, Ds^Fdf, Ds^Fdf, Ds^Fdf, Ds, Ds^Fdf, Ds^Fdf, Ds, Gll^Fts, Gll^Fts, Hhd^Fdf, Hhd, Mdd, Mdd, Ds, Wwg, Wwg, Wwg, Wwg, Ds, Ds^Fts, Ds, Gll^Fdf, Gll^Fdf, Mdd, Xu, Xu, Xu, Xu, Xu, Mdd, Xu, Xu, Xu, Xu, Xu, Xu, Xu, Xu, Xu, Xu, Xu, Xu, Xu, Xu, Xu, Xu, Xu, Xu, Xu, Xu, Xu, Xu, Xu, Xu, Xu, Xu, Xu, Xu, Xu, Xu, Xu, Xu, Xu, Xu, Xu
Gll^Fdf, Gd, Gll^Fdf, Ds, Ds^Fdf, Ds^Fdf, Hhd^Fdf, Gll^Fdf, Gll^Fdf, Hhd^Fdf, Hhd^Fdf, Gll^Fdf, Hhd^Fdf, Hhd^Fdf, Mdd, Mdd, Ds, Wwg, Wwg, Wwg, Gll^Fdf, Ds, Xu, Xu, Xu, Xu, Xu, Xu, Xu, Xu, Xu, Xu, Xu, Xu, Xu, Xu, Xu, Xu, Xu, Xu, Xu, Xu, Xu, Xu, Xu, Xu, Xu, Xu, Xu, Xu, Xu, Xu, Xu, Xu, Xu, Xu, Xu, Xu, Xu, Xu, Xu, Xu, Xu, Xu, Xu, Xu, Xu, Xu, Xu
Ds^Fdf, Ds, Ds^Fdf, Ds^Fdf, Ds, Gll^Fdf, Hhd^Fdf, Hhd^Fdf, Hhd, Hhd^Fdf, Mdd, Hhd, Mdd, Mdd, Mdd, Mdd, Ds, Wwg, Wwg, Hhd, Gll^Fdf, Gll^Fdf, Xu, Xu, Xu, Xu, Xu, Xu, Xu, Xu, Xu, Xu, Xu, Xu, Xu, Xu, Xu, Xu, Xu, Xu, Xu, Xu, Xu, Xu, Xu, Xu, Xu, Xu, Xu, Xu, Xu, Xu, Xu, Xu, Xu, Xu, Xu, Xu, Xu, Xu, Xu, Xu, Xu, Xu, Xu, Xu, Xu, Xu, Xu
Gd, Gll^Fdf, Gll^Fdf, Ds^Fdf, Ds, Hhd^Fdf, Gll, Mdd, Mdd, Gll, Mdd, Mdd, Mdd, Mdd, Mdd, Ds, Wwg, Wwg, Hhd, Gll^Fdf, Hhd, Gll^Fdf, Gll^Fdf, Xu, Xu, Xu, Xu, Xu, Xu, Xu, Xu, Xu, Xu, Xu, Xu, Xu, Xu, Xu, Xu, Xu, Xu, Xu, Xu, Xu, Xu, Xu, Xu, Xu, Xu, Xu, Xu, Xu, Xu, Xu, Xu, Xu, Xu, Xu, Xu, Xu, Xu, Xu, Xu, Xu, Xu, Xu, Xu, Xu, Xu
