Dd, Dd, Dd, Dd, Dd, Dd, Dd, Dd, Hd, Dd, Hd, Rd, Mdd, Hd, Hd, Rd, Hd, Dd, Hd, Dd, Dd, Dd, Dd, Dd, Dd, Dd, Dd, Dd, Dd, Dd, Dd, Dd, Dd^Edp, Dd, Dd, Dd, Dd, Dd, Dd^Edp, Dd^Edp, Dd^Edp, Dd, Dd, Dd, Dd, Dd
Dd, Dd, Dd, Dd, Dd, Hd, Hd, Hd, Hd, Hd, Hd, Hd, Mdd, Mdd^Xm, Mdd, Hd, Hd, Hd, Dd, Dd, Dd^Edp, Dd, Dd^Edp, Dd, Dd, Dd, Dd, Dd, Dd, Dd^Edp, Dd^Edp, Dd, Dd, Dd, Dd, Dd, Dd, Dd^Edp, Dd^Edp, Dd^Edp, Dd^Edp, Dd^Edp, Dd^Edp, Dd^Edp, Dd^Edp, Dd
Dd, Dd^Edb, Dd^Edb, Dd, Dd, Hd, Hd, Mdd, Mdd^Xm, Mdd, Mdd^Xm, Mdd, Mdd, Mdd, Mdd, Hd, Mdd, Dd, Dd, Dd, Dd, Dd^Edp, Dd^Esd, Dd, Dd, Dd, Dd, Dd^Dc, Dd^Edb, Dd, Dd, Dd^Esd, Dd, Dd, Rd, Dd, Dd, Dd^Edp, Dd^Edp, Dd^Edp, Dd^Edp, Dd^Edp, Dd^Edp, Dd^Edp, Dd^Edp, Dd^Edp
Dd, Dd, Dd^Edb, Dd^Edb, Hd, Hd, Hd, Hd, Mdd, Mdd, Mdd, Mdd, Mdd^Xm, Mdd, Mdd, Hd, Hd, Dd, Dd, Dd, Dd, Dd^Esd, Dd, Dd, Dd, Dd^Esd, Dd^Esd, Dd^Esd, Dd^Edb, Dd^Edb, Rd, Rd, Dd, Rd, Rd, Dd, Dd, Rd, Dd, Dd^Edp, Dd^Edp, Dd^Edp, Dd^Edp, Dd^Edp, Dd^Edp, Dd^Edp
Dd, Dd, Dd, Dd^Dc, Dd, Hd, Hd, Hd, Mdd, Mdd, Mdd, Mdd, Mdd, Mdd, Mdd, Hd, Dd^Rusy, Hd, Dd^Rusy, Dd^Rusy, Dd, Dd, Dd, Dd, Dd, Dd, Dd, Dd, Dd, Dd^Edb, Dd, Dd, Rd, Rd, Re, Re, Dd, Rd, Rd, Dd^Edp, Dd^Edp, Dd^Edp, Dd^Edp, Dd^Edp, Dd^Edp, Dd
Dd, Dd, Dd, Dd^Esd, Hd, Hd, Mdd, Mdd^Xm, Mdd, Mdd, Mdd, Mdd, Hd, Hd, Hd, Hd, Dd^Rusy, Dd^Rusy, Dd^Rusy, Dd^Rusy, Dd, Dd, Dd, Dd^Edp, Dd^Edp, Dd^Edp, Dd, Dd, Dd, Dd, Dd, Rd, Rd, Dd, Rd, Re, Rd^Esd, Rd, Re, Re, Rd, Rd, Rd, Dd^Edp, Dd, Dd
Dd, Dd, Dd, Dd, Hd, Hd, Hd, Mdd, Hd, Hd, Hd, Hd, Mdd, Mdd, Hd, Hd, Dd^Rusy, Dd^Rusy, Dd^Rusy, Dd, Dd, Dd, Dd^Edb, Dd, Dd, Dd, Dd, Dd, Dd, Dd, Dd, Dd, Dd, Re, Re, Rd, Dd, Rd, Rd, Re, Dd, Rd, Rd, Dd, Dd, Dd
Dd, Dd, Dd, Dd, Dd^Edp, Dd, Dd, Hd, Dd, Hd, Dd, Mdd, Dd, Mdd, Dd^Edb, Dd, Dd, Dd^Rusy, Dd, Dd^Rusy, Dd, Dd^Edb, Dd^Edb, Dd, Dd, Dd, Hd, Dd, Dd, Dd, Dd, Dd, Rd, Re, Re, Rd, Dd, Dd^Dc, Rd, Dd, Rd, Dd, Dd^Esd, Dd, Dd, Dd
Dd, Dd, Dd, Dd, Dd^Edp, Dd^Edp, Dd, Dd, Dd, Dd, Dd, Dd^Edb, Dd^Edb, Dd^Edb, Dd, Dd, Dd, Dd, Dd, Dd, Hd, Dd, Hd, Dd, Hd, Hd, Hd, Dd, Dd, Rd, Dd, Rd, Dd, Rd, Dd, Rd, Rd, Rd, Dd, Dd, Rd, Dd, Dd, Dd, Dd^Edp, Dd
Dd, Dd, Dd, Dd^Edp, Dd^Edp, Dd, Dd^Edp, Dd, Dd, Dd, Ds, Dd^Edb, Dd^Edb, Dd^Edb, Dd^Edb, Dd^Dc, Dd^Esd, Dd, Dd, Hd, Dd, Hd, Hd, Hd, Hd, Hd, Dd, Dd, Dd, Dd, Rd, Dd, Rd, Rd, Dd, Dd, Dd, Rd, Dd, Dd^Esd, Dd, Dd, Dd^Edp, Rd^Edp, Dd, Dd
Dd, Dd^Edp, Dd^Edp, Dd^Edp, Dd^Edp, Dd, Dd, Dd^Edb, Ds^Edb, Ds^Edb, Dd, Dd, Dd^Esd, Dd^Esd, Dd, Dd^Edb, Dd, Dd, Dd^Esd, Dd, Rd, Dd, Hd, Hd, Hd, Dd, Dd, Rd, Rd, Rd, Dd, Rd, Rd, Rd, Dd, Dd, Dd, Dd, Dd^Esd, Dd^Esd, Dd^Esd, Dd, Dd, Rd^Edp, Dd, Dd
Dd, Dd, Dd, Dd, Dd^Edb, Dd, Dd, Dd, Dd, Ds^Edb, Dd^Edb, Dd^Esd, Dd, Dd, Dd, Dd, Dd, Dd, Dd, Dd, Rd, Dd, Dd, Hd, Dd, Rd, Dd^Vdr, Dd, Rd, Rd, Dd, Dd, Dd^Rusy, Rd, Dd, Dd, Dd, Dd^Esd, Dd^Edp, Dd, Dd^Edp, Dd^Edp, Dd^Edp, Dd^Edp, Dd^Edp, Dd
Dd, Dd, Dd, Dd, Dd^Edb, Dd^Edb, Dd, Dd, Dd^Esd, Ds^Edb, Dd, Dd^Edb, Dd, Dd, Dd, Dd, Dd, Rd, Rd, Dd, Re, Rd, Dd^Dc, Dd, Rd, Rd^Rusy, Re^Rusy, Rd, Rd^Esd, Dd, Dd, Dd^Rusy, Dd^Rusy, Dd, Dd^Rusy, Dd^Rusy, Dd^Rusy, Dd, Hd, Dd^Edp, Dd, Dd^Edp, Dd, Dd, Dd, Dd
Hd, Hd, Hd, Dd, Dd, Dd^Edb, Dd, Dd^Dc, Dd, Dd, Dd, Dd, Dd, Dd^Esd, Dd, Dd^Dc, Dd, Dd, Rd, Re, Re, Rd, Ds, Dd, Rd, Re^Rusy, Re, Rd, Dd^Esd, Dd^Edb, Dd, Dd, Dd^Edb, Dd^Rusy, Dd^Rusy, Dd^Rusy, Dd^Rusy, Hd, Hd, Dd, Dd, Dd, Dd, Dd, Dd, Dd
Dd, Hd, Hd, Dd, Hd, Hd, Dd, Dd, Dd, Dd, Dd, Hd, Hd, Hd, Hd, Dd, Dd, Rd, Dd, Re, Re, Re, Rd, Ds, Rd, Re, Rd^Vdt, Dd, Dd, Dd^Rusy, Dd, Dd^Dc, Dd, Dd^Vdr, Dd^Rusy, Dd^Rusy, Dd^Rusy, Hd, Hd, Hd, Dd, Dd, Dd, Dd, Dd, Dd
Dd, Hd, Hd, Hd, Hd, Dd, Dd, Dd, Dd, Dd^Rusy, Dd, Hd, Hd, Hd, Hd, Hd, Hd, Dd, Ds^Rusy, Ds, Re, Re, Re, Rd, Re, Re, Ce, Rd, Rd, Dd^Rusy, Dd, Dd, Dd, Dd, Rd, Dd, Dd, Dd, Hd, Hd, Hd, Dd, Dd, Dd, Dd, Dd
Dd, Hd, Hd, Hd, Hd, Hd, Dd, Dd, Dd, Dd, Dd^Rusy, Dd^Rusy, Dd^Edp, Hd, Hd, Hd, Ds, Dd^Vdr, Ds, Ds^Rusy, Rd, Re, Rd, Rd, Rd, Ce, 1 Ke, Ce, Rd, Dd^Vdt, Ds, Ds^Edb, Rd^Edb, Rd^Edb, Dd, Dd, Hd^Edb, Hd, Hd, Hd, Hd, Dd, Hd, Dd, Dd, Dd
Dd, Hd, Dd, Hd, Dd, Hd, Dd, Dd^Rusy, Dd^Rusy, Dd, Dd, Dd, Dd, Dd^Edp, Hd, Ds, Dd, Ds, Dd, Rd^Rusy, Dd, Re, Re, Rd^Vdt, Re, Ce, Ce, Ce, Re, Rd, Ds, Ds, Dd, Dd, Dd, Dd, Dd^Dc, Dd, Hd, Hd, Hd, Hd, Dd, Dd, Dd, Dd
Dd, Dd, Dd, Dd, Dd^Edp, Dd, Dd^Edp, Dd^Rusy, Dd^Rusy, Dd^Rusy, Dd, Dd, Dd, Hd, Dd^Rusy, Dd^Rusy, Dd, Rd, Re, Rd, Re, Rd, Rd, Re, Rd^Vdt, Re, Re, Re, Rd, Rd, Rd^Vdt, Re, Rd, Dd, Dd, Dd, Dd, Hd, Hd, Hd, Hd, Hd, Dd, Dd, Dd^Edp, Dd
Dd, Dd, Dd, Dd^Edp, Dd^Edp, Dd^Edp, Dd, Dd^Rusy, Dd^Rusy, Dd^Rusy, Dd^Esd, Dd, Dd, Dd^Rusy, Dd, Dd^Rusy, Rd, Rd, Re, Re, Rd, Rd, Rd, Rd, Re, Re, Rd, Re, Rd, Rd, Hd, Rd, Hd, Dd, Hd, Dd, Dd, Dd^Rusy, Dd^Esd, Dd, Dd^Edp, Dd, Dd^Edp, Dd^Edp, Dd, Dd
Dd, Dd, Dd, Dd^Edp, Dd, Dd^Edp, Dd^Edp, Dd^Vdr, Dd^Rusy, Dd^Esd, Dd^Dc, Dd, Dd, Dd, Dd, Dd, Dd, Rd, Re, Dd^Edb, Dd^Dc, Rd, Dd, Rd, Dd, Rd, Rd, Rd, Rd, Hd, Rd, Hd, Hd, Hd, Dd^Vdr, Dd^Rusy, Dd^Rusy, Dd^Rusy, Dd, Dd, Dd, Dd, Dd, Dd, Dd, Dd
Dd, Dd, Dd, Dd, Dd, Dd, Dd, Dd, Dd, Dd, Dd^Esd, Dd, Dd, Dd, Dd, Dd, Rd, Rd, Dd, Dd^Edb, Rd, Rd, Rd, Dd, Dd^Edb, Dd^Rusy, Rd, Re, Re, Rd, Dd, Rd, Hd, Hd, Dd, Dd, Dd, Dd^Rusy, Dd, Dd, Dd, Dd, Dd, Dd, Dd, Dd
Dd, Dd, Dd, Dd, Dd, Dd, Hd, Dd, Hd, Dd, Dd, Dd, Rd, Rd, Re, Rd, Re, Rd, Rd, Rd, Ds, Rd, Ds, Ds, 2 Dd^Dc, Dd^Edb, Dd, Re, Re, Re, Dd, Dd, Dd, Dd^Rusy, Dd, Dd^Dc, Dd, Dd^Edb, Dd^Rusy, Dd, Dd, Dd, Dd^Edp, Dd, Dd, Dd
Dd, Dd, Dd, Dd, Dd, Hd, Hd, Hd, Hd, Dd, Dd, Dd, Dd, Rd, Dd, Re, Dd, Re, Dd, Ds, Hd, Ds, Ds, Dd, Dd, Dd^Edb, Dd, Rd, Dd, Rd, Rd, Re, Re, Dd, Rd, Dd, Dd^Rusy, Dd^Rusy, Dd, Dd, Dd^Edp, Dd^Edp, Dd^Edp, Dd^Edp, Dd, Dd
Dd, Dd, Dd, Dd, Hd, Hd, Dd, Hd, Hd, Hd, Hd, Re, Re, Rd, Dd, Dd, Dd, Dd, Hd, Hd, Mdd, Hd, Dd, Dd, Dd^Vdr, Dd, Dd^Rusy, Dd, Rd, Dd, Rd, Re, Rd, Rd, Dd, Dd, Dd, Dd^Rusy, Dd, Dd, Dd, Dd^Edp, Dd^Edp, Dd, Dd, Dd
Dd, Dd, Hd, Dd, Dd, Rd, Rd, Hd, Hd, Hd, Hd, Rd, Dd, Dd, Dd, Dd, Hd, Hd, Hd, Mdd, Mdd, Hd, Hd, Hd, Dd, Dd^Rusy, Dd^Rusy, Rd, Rd, Rd, Dd, Rd, Dd, Dd^Edp, Dd^Edp, Dd, Dd, Dd, Dd, Dd, Dd, Dd, Dd, Dd, Dd, Dd
Dd, Dd, Hd, Hd, Dd^Edp, Dd, Dd, Dd, Hd, Hd, Hd, Hd, Dd, Hd, Hd, Dd, Hd, Hd, Mdd, Mdd, Mdd, Hd, Mdd, Hd, Dd, Dd, Dd, Dd, Dd, Dd, Dd^Esd, Dd, Dd, Dd^Edp, Dd^Edp, Dd^Edp, Dd, Dd, Dd^Dc, Dd, Dd, Dd, Dd, Dd, Rd, Dd
Dd, Dd, Dd^Edp, Hd, Hd, Dd^Edp, Dd, Hd, Hd, Hd, Hd, Hd, Hd, Hd, Mdd, Hd, Hd, Mdd, Mdd, Mdd, Mdd, Hd, Hd, Hd, Dd, Dd, Dd, Rd, Dd, Dd, Dd, Dd, Dd^Edp, Dd^Edp, Dd^Edp, Dd^Edp, Dd, Dd, Dd, Dd, Dd, Dd, Dd, Dd, Re, Dd
Dd, Dd, Dd, Dd^Edp, Dd^Edp, Dd, Dd^Esd, Dd, Dd, Hd, Dd, Mdd, Mdd, Mdd, Mdd, Hd, Mdd, Mdd, Mdd, Mdd, Mdd, Mdd, Mdd, Hd, Dd, Dd, Rd, Dd, Dd, Dd, Dd, Dd, Rd, Dd, Dd^Esd, Dd^Edp, Dd, Dd, Dd, Dd, Dd, Dd, Re, Re, Re, Rd
Dd, Dd, Dd, Dd^Edp, Dd, Dd, Dd, Dd^Edb, Dd, Dd^Esd, Dd, Mdd, Dd, Mdd, Hd, Hd, Mdd, Mdd, Mdd^Edb, Mdd, Mdd, Mdd, Mdd, Dd, Dd, Rd, Dd, Re, Re, Re, Rd, Dd, Rd, Dd^Esd, Dd, Dd^Esd, Dd, Dd, Dd, Rd, Rd, Rd, Re, Re, Rd, Rd
Dd, Dd, Dd, Rd, Re, Rd, Dd^Dc, Dd^Edb, Dd, Dd, Hd, Hd, Hd, Hd, Mdd, Mdd, Mdd, Mdd, Mdd, Mdd, Hd, Mdd, Mdd, Mdd, Dd, Dd, Rd, Re, Dd, Re, Rd^Esd, Dd^Esd, Dd^Edp, Dd, Dd^Edp, Dd, Dd, Dd, Dd, Dd, Re, Dd, Dd, Rd, Dd, Dd
Dd, Rd, Dd, Rd, Re, Dd, Dd, Dd, Rd, Dd, Dd, Hd, Hd, Mdd, Mdd, Mdd, Mdd, Mdd, Mdd, Mdd, Dd, Hd, Dd^Esd, Dd, Dd, Dd, Rd, Re, Dd, Dd, Dd^Edp, Dd, Dd^Edp, Dd^Edp, Dd, Dd, Dd, Dd, Dd^Dc, Dd, Dd, Re, Rd, Dd, Rd, Dd
Dd, Dd, Re, Re, Dd, Rd, Re, Re, Re, Dd, Dd, Dd, Hd, Hd, Mdd, Mdd, Hd, Hd, Hd, Dd, Dd, Dd, Rd, Dd, Re, Re, Re, Rd, Rd, Dd, Dd, Dd^Edp, Dd, Dd^Edp, Dd, Dd, Dd, Rd, Dd, Dd, Re, Re, Rd, Dd, Re, Rd
Rd, Rd, Re, Re, Re, Dd, Rd, Re, Re, Re, Dd, Dd, Dd, Hd, Hd, Mdd, Hd, Hd, Mdd, Mdd, Mdd, Dd, Dd, Rd, Re, Re, Dd, Dd, Rd, Dd, Rd, Dd, Dd, Dd, Dd, Rd, Rd, Dd, Rd, Rd, Rd, Re, Dd, Rd, Rd, Re
Dd, Rd, Dd, Rd, Dd, Re, Rd, Re, Rd, Rd, Dd, Dd, Dd, Dd, Dd, Hd, Dd, Dd, Dd, Mdd, Dd, Rd, Dd, Rd, Rd, Dd, Dd, Rd, Dd, Dd, Dd, Rd, Dd, Dd, Dd, Dd, Dd, Rd, Rd, Dd, Dd, Rd, Rd, Rd, Dd, Dd
