Dd, Dd, Dd, Dd, Dd, Dd, Dd, Dd, Dd, Rd, Rd, Rd, Rd, Dd, Rd, Dd, Re, Dd, Rd, Dd, Dd, Dd, Dd, Dd, Dd, Dd, Dd, Dd, Dd, Dd, Hd, Dd, Rd, Rd, Rd, Dd, Dd, Dd, Rd, Dd, Dd, Dd, Rd, Dd, Rd, Rd
Dd, Dd, Dd, Dd, Rd, Dd, Rd, Dd, Rd, Re, Re, Rd, Dd, Dd, Rd, Rd, Re, Rd, Dd, Dd, Dd, Dd, Rd, Rd, Dd, Dd, Dd^Edp, Dd^Edp, Dd^Edp, Dd, Hd, Hd, Rd^Es, Rd, Dd, Dd, Rd, Rd, Rd, Re^Vct, Dd, Rd, Rd, Dd^Vdt, Dd^Edp, Rd
Dd, Dd, Dd^Edp, Re, Re, Rd, Re, Rd, Re, Re, Dd, Dd^Edp, Dd, Dd, Re, Re, Rd, Dd, Rd, Rd, Dd, Rd, Rd, Rd, Dd, Dd^Edp, Dd, Dd, Dd, Hd, Re, Re, Re, Rd, Re, Rd, Dd, Dd^Vdt, Dd, Rd, Rd, Re^Vct, Rd, Rd, Rd, Dd
Rd, Dd, Dd, Dd, Re, Re, Rd, Re, Rd, Dd, Dd^Edp, Dd, Rd, Re, Rd, Rd, Dd, Dd, Rd, Rd, Rd, Rd, Re, Re, Dd, Dd, Rd, Rd, Re, Hd, Rd, Re, Dd, Re, Re^Es, Re, Re, Rd, Ce, Ce, Ce, Rd, Rd, Rd, Dd, Rd
Dd, Dd, Dd, Rd, Re, Re, Re, Rd, Rd, Dd, Rd, Dd, Re, Re, Rd, Dd, Dd^Edp, Dd^Edp, Dd, Rd, Rd, Re, Re, Dd, Dd, Dd, Rd, Rd, Hd, Re, Rd, Dd, Dd, Rd, Dd, Re, Rd, Re, Ce, 3 Ket, Ce, Re, Dd, Dd^Vdt, Rd, Rd
Re, Rd, Rd, Rd, Re, Re, Re, Re, Re, Re, Re, Re, Re, Rd, Rd, Dd, Dd^Edp, Dd^Edp, Dd^Edp, Dd, Rd, Rd, Rd, Dd, Dd, Dd, Rd, Hd, Hd, Rd, Dd, Dd, Hd, Dd, Rd, Rd, Re, Re, Re, Ce, Re, Rd, Dd, Rd, Rd, Rd
Rd, Re, Re, Re, Rd, Rd, Rd, Re, Rd, Rd, Rd, Re, Rd, Re, Re, Rd, Rd, Dd^Edp, Dd^Edp, Dd, Dd, Rd, Dd^Esd, Hd, Hd, Rd, Rd, Dd, Dd^Edp, Dd, Dd, Hd, Hd, Dd, Re, Rd, Re, Re, Re, Re, Re, Re, Rd, Rd, Dd, Dd
Rd, Rd, Rd, Rd, Rd, Dd, Dd, Dd, Rd, Rd, Rd, Dd, Dd, Rd, Re, Re, Rd, Dd^Edp, Dd, Dd, Dd^Esd, Dd^Esd, Dd, Hd, Hd, Dd, Rd, Dd, Dd^Edp, Dd^Edp, Rd, Rd, Hd, Rd, Rd, Rd, Re, Re, Rd, Rd, Rd, Rd, Rd, Rd, Dd, Dd
Rd, Rd, Dd, Rd, Rd, Dd, Rd, Dd, Dd, Rd, Dd, Dd, Rd, Rd, Rd, Re, Re, Rd, Rd, Dd, Dd, Dd, Dd, Hd, Hd, Dd, Dd, Dd, Dd, Dd, Dd, Rd, Rd, Rd, Rd, Re, Rd, Rd^Es, Rd, Rd, Dd, Dd, Dd, Dd, Re^Vct, Rd
Re, Rd, Rd, Rd, Rd, Dd, Rd, Dd, Dd, Dd, Dd^Edp, Dd, Dd, Rd, Dd, Rd, Rd, Rd, Rd, Dd, Rd, Dd, Dd^Esd, Hd, Hd, Hd, Hd, Dd, Dd, Dd, Dd, Dd^Esd, Rd, Dd, Rd, Rd, Hd, Rd, Hd, Hd, Dd, Hd, Dd, Rd, Rd, Rd
Re, Re, Rd, Rd, Re, Rd, Rd, Rd, Dd, Dd^Edp, Dd^Edp, Dd, Dd, Rd, Rd, Dd, Rd, Re, Re, Rd, Rd, Dd, Hd, Hd, Hd, Hd, Hd, Hd, Hd, Dd, Dd, Rd, Dd, Rd, Rd, Hd, Rd, Hd, Dd^Edp, Dd^Edp, Dd^Edp, Dd^Edp, Dd, Rd, Rd, Rd
Rd, Re, Re, Re, Rd, Re, Re, Rd, Rd, Dd^Edp, Rd, Dd^Edp, Dd^Edp, Dd, Dd, Rd, Dd, Re, Re, Rd, Dd, Hd, Hd, Hd, Dd^Esd, Hd, Hd, Hd, Rd, Rd, Re, Rd, Re, Dd, Rd, Dd, Rd, Dd, Dd, Dd, Rd, Dd, Rd, Rd, Rd, Rd
Rd, Rd, Rd, Dd, Rd, 1 Re, Rd, Re, Re, Rd, Rd, Rd, Rd, Rd, Rd, Dd, Dd, Re, Rd, Dd, Dd, Dd, Dd, Dd, Dd, Dd, Dd, Hd, Dd, Re, Rd, Re, Re, Rd, Rd, Rd, Rd, Rd, Rd, Rd, Dd, Hd, Dd, Rd, Rd, Dd
Dd, Dd, Ds^Edp, Dd, Dd, Dd, Dd, Rd, Rd, Re, Re, Dd, Rd, Re, Rd, Dd, Dd, Re, Rd, Re, Dd, Dd^Dc, Dd, Dd, Dd^Edp, Dd^Esd, Rd, Rd, Hd, Rd, Rd, Rd, Re, Re, Rd, Rd, Dd, Rd, Rd, Rd, Dd, Hd, Dd, Rd, Rd, Dd
Ds, Ds, Ds, Rd, Ds, Dd, Ds, Dd, Dd, Dd, Dd, Re, Re, Re, Re, Re, Rd, Dd, Rd, Re, Rd, Dd, Dd, Dd^Edp, Dd, Dd, Dd, Dd, Rd, Rd, Dd, Dd, Re, Re, Rd, Dd, Dd^Edp, Dd, Dd^Edp, Dd, Dd^Edp, Dd, Rd, Rd, Rd, Dd
Ww, Ds, Ds, Ds, Ds, Ds, Ds, Dd, Dd, Dd, Dd^Ftd, Dd, Dd, Dd^Dc, Re, Re, Rd^Dr, Dd, Re, Re, Rd, Dd, Dd, Dd, Rd, Rd, Dd, Rd, Dd, Dd, Dd, Dd, Re, Rd, Dd, Dd, Dd^Edp, Dd^Edp, Dd^Edp, Dd^Edp, Dd, Dd, Rd, Rd, Rd, Dd
Ww, Ww, Wwr, Wwr, Ds, Dd^Ftd, Dd, Dd, Dd^Ftd, Gd, Gs^Ftd, Dd, Dd^Ftd, Dd, Dd, Dd, Rd, Rd, Re, Re, Rd, Rd, Dd, Rd, Rd, Dd, Rd, Dd, Rd, Dd, Re, Re, Dd, Dd, Dd, Dd, Dd, Dd, Dd, Dd^Edp, Rd, Rd, Rd, Rd, Dd, Dd
Ww, Ww, Ww, Wwr, Wwf, Ds, Dd^Vda, Dd^Ftd, Gs^Ftp, Gs^Ft, Gs^Ft, Gs^Ftd, Gs^Ft, Dd^Ftd, Dd^Ftd, Gd, Rd, Rd^Dr, Rd, Re, Re, Dd^Dc, Rd, Dd, Rd, Rd, Rd, Rd, Rd, Dd^Esd, Re, Rd, Dd, Dd, Hd, Dd, Rd, Rd, Rd, Rd, Rd, Rd, Rd, Dd, Dd^Esd, Dd
Ww, Ww, Ww, Ds, Wwf, Wwf, Ds, Gs, Gs^Ftp, Gs^Ft, Gs^Ft, Gs^Ft, Gs^Ft, Gs^Ftp, Gs^Ft, Gs^Ft, Cd, Rd, Cdr, Rd, Re, Rd, Rd, Dd, Rd, Rd, Dd, Dd, Dd, Dd^Esd, Dd^Dc, Dd, Dd, Dd^Esd, Hd, Dd, Rd, Rd, Rd, Dd, Rd, Rd, Rd, Dd, Dd, Dd
Ww, Ww, Ww, Ds, Ww, Ww, Ww, Cdr, Wwf, Gs^Ftp, Gs^Ftp, Gs^Ftp, Wwf, Gs^Ftp, Cdr, Gs^Ft, Cd, Cd, Cd, Cd, Re, Re, Rd, Rd, Rd, Rd, Dd, Dd, Dd, Dd, Dd, Dd, Dd, Hd, Hd, Dd, Dd, Dd, Dd, Rd, Dd, Dd^Esd, Dd, Dd, Rd, Dd
Ww, Ww, Ww, Ww, Ds, Ds, Rd, Wwf, Wwf, Wwf, Wwf, Wwf, Cd, Wwf, Wwf, Gd, Rd, Rd, Re, Cd, Rd, Rd, Cd, Rd, Rd, Rd, Rd, Rd, Dd, Dd, Dd, Dd^Edp, Dd, Dd, Dd, Hd, Dd, Dd, Dd, Rd, Dd, Dd, Dd^Edp, Dd, Rd, Rd
Ww, Ww, Ww, Ww, Ds, Dd^Vda, Ds, Wwf^Bw\, Rd, Gs^Ftp, Gs^Ftp, Cd, Kd, Rd^Vda, Rd, Gd, Rd, Rd, Rd, Re, Rd, Cd, Cd, Cdr, Rd, Rd^Dr, Dd, Rd, Dd, Dd, Dd, Dd, Gd, Dd^Ftd, Gd, Dd, Dd^Ftd, Dd^Vdt, Dd, Dd, Dd, Dd^Edp, Rd, Dd, Rd, Rd
Ww, Ww, Ww, Ww, Ww, Ds, Ww, Ww, Ds, Rd, Rd, Cd, Rd^Vda, Rd, Gd, Gd, Cd, Cd, Cd, Rd, Rd, Gd, Rd, Cdr, Cdr, Rd, Gd, Dd, Dd^Ftd, Dd, Dd^Ftd, Gd, Wwf, Gd, Wwf, Gs^Efm, Gs^Ftp, Gd, Gs^Ftp, Dd^Ftd, Dd^Ftd, Rd, Rd, Rd, Rd, Dd
Ww, Ww, Ww, Ww, Ww, Ww, Wwr, Wwr, Ds, Rd, Rd, Rd, Rd, Gd, Rd, Rd, Cd, 2 Kd, Cd, Re, Rd, Rd, Gd, Cd, Gs^Ft, Gs^Ftd, Gs^Ftd, Gd^Ftd, Wwf, Wwf, Wwf, Wwf, Gs^Ftp, Wwf, Dd^Ftd, Wwf, Wwf, Gs^Ftp, Dd^Ftd, Gs^Ftp, Dd^Ftd, Dd, Hhd, Rd, Rd, Dd
Ww, Ww, Ww, Ww, Ww, Ww, Ww, Ww, Rd, Rd, Ds, Dd^Ftd, Ds, Rd, Gd^Vda, Rd, Rd, Cd, Rd, Rd, Rd, Gs, Wwf, Gs^Ftp, Cd, Gs^Ft, Gs^Ftp, Wwf, Wwf, Gs^Ftp, Gs^Ftp, Gd, Gs^Ft, Gs, Gs^Ftp, Dd, Hd, Wwf, Gs^Ftd, Gs^Ftp, Dd, Dd^Ftd, Hhd, Rd, Hhd, Dd
Ww, Ww, Ww, Ww, Rd^Qov, Ww, Wwg^Bw/, Wwg^Bw/, Wwr, Ds, Wwr, Wwr, Ds, Rd, Rd, Gd, Rd, Rd, Rd, Gd, Gs^Ft, Rd^Vda, Cdr, Wwf, Wwf, Wwf, Wwf, Wwf, Gs^Ftp, Wwf, Wwf, Gs^Ftp, Gs^Ft, Gs^Ft, Gs^Ft, Gs^Ftp, Gs^Efm, Wwf, Gs^Ftp, Dd^Ftd, Hhd^Ftp, Hhd^Ftp, Gs, Hhd, Hhd, Dd
Ww, Ww, Ww, Rd^Qov, Rd, Rd, Ww, Ww, Ww, Wwr, Wwr, Wwr, Ds, Rd, Rd, Re, Gd, Rd, Rd, Rd, Rd^Vda, Kd, Cd, Gs^Ftd, Gs^Ftd, Gs^Ftd, Gs^Ft, Gs^Ftp, Gs^Ft, Gs^Ftp, Wwf, Gs^Ftd, Gs^Ftd, Gs^Ftd, Gs^Ft, Gs^Ftd, Gs^Ftd, Wwf, Gs^Ftd, Hhd^Ftp, Hhd^Ftd, Gs^Ftp, Hhd^Ftp, Hhd, Hhd, Hhd
Ww, Ww, Ww, Ds, Ds, Wwf^Bw\, Wwf^Bw\, Ww, Ww, Ww, Ww, Ds, Wwf, Ds, Wwf, Wwf^Bw\, Rd, Rd^Vda, Rd, Gs^Ft, Dd, Cd, Dd, Gs^Ftd, Gs^Ftd, Gs^Ftp, Gs^Ft, Gs^Ft, Gs^Ft, Gs^Ftp, Rd, Wwf, Wwf, Wwf, Wwf, Gs^Ftp, Wwf, Wwf, Gs^Ftd, Hhd^Ftd, Hhd^Ftp, Hhd^Ftp, Mdd, Hhd^Ftp, Hhd^Ftp, Hhd
Ww, Ww, Ww, Ds, Ww, Ww, Ds, Rd, Ww, Ww, Ww, Wwf, Ww, Wwf, Ww, Ds, Rd, Rd, Ds, Dd, Wwg, Wwg, Ds, Ds, Rd, Ds, Rd, Rd, Rd, Rd, Gd, Gd, Gs^Ftp, Gd, Gs^Ftp, Wwf, Wwf, Wwf, Wwf, Hhd^Ftp, Hhd^Ftp, Mdd, Mdd, Mdd, Mdd, Hhd^Ftp
Ww, Ww, Ww, Ww, Ww, Ww, Ds, Rd, Ww, Ww, Ww, Ww, Ww, Ww, Ds, Ds, Rd, Rd, Rd, Ds, Ds, Wwg, Wwg^Bw/, Rd, Cdr, Rd, Dd, Rd, Gs, Gs, Dd^Ftd, Gs^Ft, Gs^Ft, Gs^Ftp, Hhd^Ftp, Hhd^Ftp, Hhd^Ftp, Gs^Ftp, Wwf, Wwf, Hhd^Ftp, Mdd, Mdd, Mdd, Mdd, Mdd
Ww, Ww, Ww, Ww, Ww, Ww, Ww, Ww, Ww, Ww, Ww, Ww, Ww, Ww, Wwg^Bw/, Wwg^Bw/, Ds, Dd^Vda, Rd, Rd, Rd, Wwg^Bw/, Ww, Ww, Dd, Ds, Ds, Ds, Dd^Ftd, Dd, Dd^Ftd, Gs^Ftp, Hhd, Gs^Ftp, Mdd, Hhd^Ftp, Mdd, Hhd^Ftp, Hhd^Ftp, Wwf, Hhd^Ftp, Mdd, Mdd, Mdd, Hhd^Ftp, Mdd
Ww, Ww, Ww, Ww, Ww, Ww, Ww, Ww, Ww, Ww, Ww, Ww, Rd, Wwg^Bw/, Ww, Ds, Ds, Ds, Ds, Ds, Ds, Ww, Ww, Ww, Ds, Ds, Ds, Ds, Ds, Dd^Ftd, Hd, Hhd, Hhd^Ftp, Mdd, Hhd^Ftp, Mdd, Mdd, Hhd^Ftp, Hhd^Ftp, Hhd^Ftp, Mdd, Mdd, Mdd, Mdd, Hhd^Ftp, Hhd^Ftp
Ww, Ww, Ww, Ww, Ww, Ww, Ww, Ww, Ww, Ww, Ww, Rd, Rd^Qov, Ds, Ds, Ww, Ww, Ww, Ww, Ww, Ww, Ww, Ww, Ww, Ww, Ww, Ww, Ds, Dd^Ftd, Ds, Hd, Hhd^Ftp, Hhd^Ftp, Mdd, Hhd^Ftp, Mdd, Hhd^Ftp, Mdd, Mdd, Mdd, Mdd, Mdd, Mdd, Mdd, Mdd, Mdd
Ww, Ww, Ww, Ww, Ww, Ww, Ww, Ww, Ww, Ww, Rd, Rd, Ds, Ds, Ww, Ww, Ww, Ww, Ww, Ww, Ww, Ww, Ww, Ww, Ww, Wwr, Wwr, Wwr, Wwr, Ds, Hhd, Hhd^Ftp, Hhd^Ftp, Hhd^Ftp, Hhd^Ftp, Hhd^Ftp, Mdd, Hhd^Ftp, Mdd, Mdd, Mdd, Mdd, Mdd, Mdd, Mdd, Mdd
Dd, Ww, Ww, Ww, Ww, Ww, Ww, Ww, Ww, Ww, Ww, Ww, Ww, Ww, Ww, Ww, Ww, Ww, Ww, Ww, Ww, Ww, Ww, Ww, Ww, Wwr, Ww, Wwr, Ww, Ds, Ds, Hhd, Mdd, Mdd, Mdd, Mdd, Mdd, Mdd, Mdd, Mdd, Mdd, Mdd, Mdd, Mdd, Mdd, Mdd
