Gs^Ftp, Gs^Ftp, Gd, Gs^Ftp, Gs^Ftp, Gs^Ftp, Gs^Ftp, Gs^Ftp, Gd, Gd, Gd^Fts, Gs^Ftp, Gd, Gd, Gd, Gs^Ftp, Gs^Ftp, Gs^Ftp, Gs^Ftp, Gs^Ftp, Wwf, Wwf, Wwf, Wwf, Gs^Ftp, Gs^Ftp, Gs^Ftp, Gs^Ft, Gs^Ftp, Gs^Ft, Gs^Ftp, Gs^Ftp, Gs^Ftp, Gs^Ftp, Gs^Ftp, Gs^Ftp, Gs^Ftp, Gs^Ftp, Gs^Ftp, Gs^Ftp, Gs^Ftp, Gs^Ftp, Gs^Ftp, Gs^Ftp, Gs^Ftp, Gs^Ftp, Gs^Ft, Gs^Ftp, Gs^Ftp, Gs^Ftp, Wwf, Wwf, Wwf, Wwf, Wwf, Wwf, Gs^Efm, Gs^Ft, Wwf, Gs^Ftp, Gs^Ftp, Gs^Ftp, Gd^Fts, Gd^Fts, Gs^Ftp, Gs^Ftp
Gs^Ftp, Gs^Ftp, Gs^Ftp, Gd, Gd^Fts, Gd, Gd^Efm, Gd, Gd^Fts, Gd, Gd^Fts, Gd, Gs^Ftp, Gd, Gd^Efm, Gd, Gd^Fts, Gs^Ftp, Gs^Ftp, Gs^Ftp, Wwf, Wwf, Wwf, Wwf, Wwf, Gs^Ftp, Gs^Ft, Gs^Ft, Gs^Ft, Gs^Ft, Gs^Ftp, Gs, Gs^Ftp, Gd, Gs^Ftp, Gs^Ftp, Gs^Ftp, Gs^Ftp, Gs^Ftp, Gs^Ftp, Gs^Ftp, Gd, Gd, Gd^Efm, Gs^Ftp, Gd^Ftp, Gd^Fts, Gd^Fts, Gd^Fts, Gs^Ft, Wwf, Wwf, Wwf, Wwf, Wwf, Wwf, Wwf, Wwf, Gs^Ft, Gs^Ftp, Gs^Ftp, Gs^Ftp, Gs^Ftp, Gd^Fts, Gd^Fts, Gd
Gs^Ftp, Gd^Fts, Gd^Fts, Gd^Fts, Gd^Fts, Gd^Efm, Gd, Gd^Fts, Gs^Ftp, Gs^Ftp, Gs^Ftp, Gs^Ftp, Gd, Gd^Fts, Gd, Gd^Fts, Gd^Fts, Gd^Fts, Gs^Ftp, Gs^Ftp, Gs^Ftp, Gs^Ftp, Gs^Ftp, Gs^Efm, Gs^Efm, Wwf, Gd^Fts, Gd^Fts, Gd^Fts, Gs^Ftp, Wwf, Gs^Ftp, Gs^Ftp, Gs^Ftp, Gs^Ftp, Gs^Ft, Gs^Ft, Gs^Ftp, Gd, Gd, Gd, Gd^Efm, Wwf, Wwf, Gd^Efm, Gd^Ftp, Gd^Fts, Gd^Fts, Dd^Ftd, Gd^Fts, Gd^Fts, Dd^Ftd, Dd^Ftd, Wwf, Gs, Gs^Efm, Wwf, Wwf, Wwf, Gd^Fts, Gs^Ftp, Gd^Fts, Gd^Fts, Gd^Fts, Gd^Fts, Gs^Ftp
Gs^Ftp, Gs^Ftp, Gs^Ftp, Gs^Ftp, Gs^Ftp, Gd^Fts, Gd^Fts, Gd^Fts, Gd^Fts, Gs^Ftp, Gd^Fts, Gs^Ftp, Gs^Ftp, Gd^Fts, Gd^Fts, Gd^Efm, Gd^Efm, Gd^Efm, Gd^Fts, Gs^Ftp, Gd^Fts, Gs^Ftp, Gd^Fts, Gs^Ftp, Gs, Wwf, Gs, Gs, Gs^Vht, Wwf, Wwf, Gd^Efm, Gd^Efm, Gs^Ft, Gs^Ft, Gs^Ft, Gs^Ftp, Gs^Ftp, Gs^Ftp, Gs^Ft, Gd, Gs, Dd, Dd, Dd, Gd, Gd, Gd, Dd^Ftd, Gd, Dd^Ftd, Gd^Fts, Dd^Ftd, Wwf, Gs^Ftp, Gd^Efm, Wwf, Wwf, Wwf, Wwf, Gd^Fts, Gd^Fts, Gd, Gd^Fts, Gs^Ftp, Gd
Gs^Ftp, Gs^Ftp, Gs^Ftp, Gd, Gs^Ftp, Gs^Ftp, Gd^Efm, Gd^Fts, Gd^Efm, Gd^Fts, Gd^Efm, Gs^Ftp, Gd^Fts, Gs^Ftp, Gd^Fts, Gd, Gd^Efm, Gd, Gd^Fts, Gd^Fts, Gd^Fts, Gs^Ftp, Gd^Fts, Gd^Fts, Gd^Efm, Wwf, Wwf, Wwf, Wwf, Wwf, Gs^Ft, Wwf, Wwf, Gs^Ft, Gs^Ft, Gd^Efm, Gs^Ftp, Gs^Ft, Dd^Ftd, Gs^Ft, Gd, Gs^Ft, Gd, Dd, Ds, Dd^Ftd, Ds, Hd^Fts, Hd^Fts, Dd, Hd^Fts, Hd^Fts, Hd^Fts, Dd^Ftd, Wwf, Gd, Gs^Ftp, Gd^Efm, Gd, Wwf, Wwf, Wwf, Wwf, Wwf, Gs^Ftp, Wwf
Gs^Ftp, Gs^Ftp, Gs^Ft, Gs^Ftp, Gd^Fts, Gs^Ftp, Gs^Ftp, Gd^Efm, 2 Gd^Efm, Gd^Efm, Gs^Ft, Gd^Fts, Gs^Ftp, Gd^Fts, Gs^Ftp, Gd, Gd^Efm, Gd^Efm, Gd, Gd, Gd^Fts, Gd^Fts, Gd^Fts, Gd^Efm, Gd, Gd, Gs, Gs, Gd^Efm, Gs^Ft, Gs^Ft, Gs^Ft, Wwf, Gs^Ft, Wwf, Gs^Ft, Gs^Ft, Gs^Ft, Gs^Ft, Dd^Ftd, Dd^Ftd, Dd^Ftd, Hd^Fts, Hd^Fts, Ds, Hd^Fts, Ds, Dd, Dd^Vdt, Hd, Hd, Hd, Ds, Dd^Ftd, Gd, Gs^Ftp, Dd^Vdt, Gs^Ft, Wwf, Wwf, Wwf, Wwf, Wwf, Wwf, Wwf, Gs^Ftp
Gd^Fts, Gs^Ft, Gd^Fts, Gd^Fts, Gd^Fts, Gd^Fts, Gd^Fts, Gd^Efm, Gd^Efm, Gd^Efm, Gd^Efm, Gs^Ft, Gd^Fts, Gd^Fts, Gs^Ftp, Gd^Fts, Gs^Ftp, Gs^Ftp, Gs^Ftp, Gd, Gd^Fts, Gd^Fts, Gd^Fts, Gd, Re, Re, Rd, Rd, Rd, Gd, Rd, Gs^Vht, Gs^Ft, Wwf, Wwf, Wwf, Gs^Ft, Gs^Ft, Gs^Ft, Gs^Ft, Gd^Ftd, Hd^Fts, Hd^Fts, Dd, Dd, Dd, Dd, Dd, Dd, Dd, Hd, Ds, Ds, Ds^Edt, Ce, Ce, Gs^Ftp, Gs^Ftp, Gs^Ftp, Gs^Ftp, Gs^Ftp, Gs^Ftp, Wwf, Wwf, Wwf, Wwf
Gd, Gs^Ft, Gs, Gd^Fts, Gs, Gs, Gd, Gd^Fts, Gd^Fts, Gs^Ftp, Gs^Ftp, Gd^Fts, Gd^Fts, Gd^Efm, Gd, Gs^Ftp, Dd^Ftd, Dd^Ftd, Gd, Gd, Gd, Re, Re, Re, Dd^Ftd, Rd, Rd, Gd^Efm, Gd^Efm, Re, Gd^Fts, Gs^Ft, Gd^Fts, Wwf, Wwf, Wwf, Wwf, Wwf, Gs^Ft, Gs^Ft, Rd, Rd, Dd, Dd, Dd, Hd, Hd, Hd, Dd, Dd, Dd, Dd^Vdt, Ds, Ds, Ds, Gs, Ce, Ket, 3 Ket, Gs^Ftp, Gs^Ft, Gs^Ft, Gs^Ftp, Wwf, Wwf, Gs^Ft
Gd, Gd^Efm, Gd, Rd, Rd, Rd, Rd, Gs, Gs, Gd^Fts, Gd^Fts, Gd^Fts, Gd^Efm, Gs^Efm, Gs^Ftp, Gs, Gd, Dd^Ftd, Dd^Ftd, Rd, Rd, Rd, Gd^Fts, Dd^Ftd, Dd^Ftd, Dd^Ftd, Gd^Fts, Rd, Rd, Re, Gd, Gs^Ft, Gd^Fts, Gd^Fts, Wwf, Gs^Ft, Wwf, Wwf, Wwf, Gs^Ft, Dd^Ftd, Rd, Rd, Rd, Dd^Esd, Rd, Hd, Dd, Hd, Dd, Dd, Ds^Edt, Ds, Ce, Ds, Ce, Ce, Ce, Ket, Gd^Efm, Gs^Ft, Gs^Ft, Gs^Ft, Gs^Ft, Gs^Ft, Gs^Ft
Dd, Gd^Efm, Re, Re, Gd^Efm, Gd^Efm, Gd, Re, Re, Gd, Gd^Fts, Rd, Rd, Rd, Rd, Gd^Fts, Gd, Dd^Ftd, Re, Re, Dd^Ftd, Gd^Efm, Gd^Efm, Gs^Ftp, Gs^Ftp, Gs^Ftp, Gd^Efm, Gd^Fts, Rd, Re, Re, Gs, Gd^Fts, Gd^Efm, Gd^Fts, Wwf, Wwf, Gd, Hd, Gd, Dd^Ftd, Rd, Rd, Dd, Rd, Hd, Hd, Dd, Rd, Dd, Ds^Esd, Ds^Edt, Ds^Edt, Ce, Ds^Edt, Ce, Ce, Ce, Gs, Gd, Wwf, Wwf, Gs^Ft, Gs^Ft, Gs^Ft, Gs^Ft
Dd, Re, Dd, Re, Dd, Gd^Efm, Gd^Fts, Re, Re, Gd, Re, Re, Gs^Ftp, Gd^Fts, Gd^Fts, Rd, Re, Re, Re, Re, Dd^Ftd, Gd^Fts, Gd^Efm, Gs^Ftp, Gs^Ftp, Gd^Fts, Gd, Gd, Gd^Fts, Re, Rd, Re, Re, Rd, Gs, Gd^Efm, Gd, Gd, Gd, Dd, Rd, Dd, Dd, Hd, Hd, Hd, Dd, Re, Re, Re, Ds, Ds^Edt, Ds^Edt, Ds^Edt, Ce, Ds, Ds, Dd^Vdt, Ce, Gs^Ft, Gs^Ft, Gs^Ft, Gs^Ft, Gs^Ft, Gs^Ft, Gs^Ft
Dd, Dd, Dd, Dd^Vdt, Dd, Gd^Fts, Dd^Edp, Gd^Fts, Gd^Fts, Re, Gs^Ftp, Gs^Ftp, Gs^Ftp, Gs^Ftp, Gd^Fts, Dd^Ftd, Gd, Dd^Ftd, Dd^Ftd, Re, Re, Gd, Gd^Fts, Gs^Ftp, Gs^Ftp, Gs^Ftp, Gs^Ftp, Dd^Ftd, Dd^Ftd, Gd^Fts, Rd, Re, Rd, Re, Re, Re, Rd, Rd, Rd, Rd, Re, Dd, Hd, Hd, Hd, Hd, Dd, Dd, Re, Ds, Ds, Ds, Ds, Dd^Vdt, Ds, Ce, Ds, Ce, Gd, Gd, Gd^Fts, Dd^Vdt, Gs^Ft, Gd^Fts, Gd^Fts, Gs^Ft
Dd, Dd, Dd^Edp, Dd, Dd, Gd^Fts, Dd^Edp, Gd^Fts, Dd^Ftd, Dd^Ftd, Gs^Ftp, Gs^Ftp, Gd^Fts, Gs^Ftp, Gd^Fts, Gs^Ftp, Gs, Dd^Ftd, Dd^Ftd, Dd^Ftd, Dd^Ftd, Rd, Rd, Gd^Fts, Dd^Ftd, Dd^Ftd, Dd^Ftd, Dd^Ftd, Dd^Ftd, Hd^Fts, Dd, Ds, Rd, Rd, Hd, Rd, Rd, Rd, Rd, Rd, Re, Re, Re, Hd, Hd, Hd, Hd, Rd, Re, Re, Dd^Vdt, Ds^Edt, Ds, Ds, Dd, Dd, Ds^Edt, Ds, Gs, Gd^Ftp, Gd^Fts, Gd^Fts, Gd^Fts, Gd^Fts, Gd^Fts, Gs^Ft
Dd, Dd^Edp, Dd^Edp, Dd^Edp, Dd, Dd^Edp, Dd^Edp, Dd^Edp, Dd^Ftd, Dd^Ftd, Dd^Ftd, Dd^Ftd, Gd^Fts, Gd^Fts, Gd^Efm, Gd^Efm, Gd^Efm, Gs^Ftp, Dd^Ftd, Dd^Ftd, Gd^Fts, Gd, Re, Rd, Hd, Dd^Ftd, Dd^Ftd, Dd^Edp, Ds^Edp, Hd^Fts, Ds, Dd, Dd, Dd, Hd, Rd, Hd^Fts, Hd^Fts, Hd^Fts, Hd^Fts, Rd, Rd, Re, Rd, Hd, Hd, Hd, Hd, Rd, Dd, Re, Rd, Dd, Dd, Ds, Rd, Rd, Rd, Re, Re, Dd^Vdt, Rd, Re, Re, Re, Gd^Fts
Ds, Ds, Ds, Dd, Dd, Dd^Edp, Dd^Edp, Dd, Dd, Dd^Ftd, Gd^Efm, Gd, Gs^Ftp, Gd^Fts, Gd^Fts, Gd^Efm, Gd^Fts, Gs^Efm, Gs^Ftp, Gd^Fts, Gd^Fts, Rd, Rd, Re, Dd, Dd^Edp, Ds^Edp, Ds, Ds, Ds, Ds, Ds, Ds, Ds^Esd, Hd, Hd, Hd^Fts, Hd^Fts, Dd, Dd, Rd, Re, Re, Rd, Dd, Hd, Hd, Hd, Hd, Dd, Re, Dd, Dd, Rd, Ds, Rd, Re, Dd, Ds, Re, Re, Re, Re, Re, Re, Rd
Ds, Ds, Dd^Edp, Dd, Dd, Dd^Edp, Dd^Edp, Dd, Ds, Dd, Dd^Ftd, Gd^Efm, Gs^Ftp, Gd^Fts, Gd^Fts, Gd^Fts, Gd^Fts, Gs^Ftp, Gs^Ftp, Gd^Fts, Dd^Ftd, Dd, Re, Re, Dd, Dd, Ds^Edp, Ds^Edp, Ds, Ds, Hd, Hd, Hd, Hd, Hd, Hd, Hd, Hd, Ds, Ds, Ds, Ds, Re, Rd, Rd, Rd, Hd, Dd, Dd, Dd, Rd, Re, Re, Re, Rd, Rd, Re, Re, Re, Re, Re, Re, Re, Dd, Dd, Dd
Dd^Edp, Dd^Edp, Dd, Dd, Dd, Dd, Dd, Dd, Ds, Hd^Fts, Hd^Fts, Gd^Efm, Gd^Efm, Gd^Fts, Gs^Efm, Gd^Fts, Gd^Fts, Gd^Fts, Gd^Fts, Gd^Fts, Dd^Ftd, Dd^Ftd, Re, Dd, Dd, Ds, Hd, Hd, Ds, Hd, Hd, Hd, Hd, Dd^Vdt, Ds, Ds, Hd, Rd, Ds, Rd, Dd, Re, Re, Dd, Rd, Rd, Rd, Rd, Rd, Rd, Rd, Re, Re, Re, Rd, Dd, Dd, Ds, Rd, Ds, Rd, Rd, Dd, Dd, Dd, Dd
Ds, Dd^Edp, Dd^Edp, Ds, Dd, Dd, Dd, Dd, Ds, Ds, Hd^Fts, Dd^Ftd, Dd^Ftd, Gd^Fts, Gd^Fts, Gs^Ftp, Gd^Fts, Gd^Efm, Gd, Dd^Ftd, Rd, Re, Re, Ds, Hd, Hd, Hd, Hd, Hd, Hd, Hd, Hd, Hd, Dd, Dd, Dd, Ds, Rd, Rd, Dd, Rd, Rd, Hd, Hd, Hd, Dd, Rd, Dd, Rd, Dd, Rd, Dd, Dd, Dd, Dd, Dd, Dd, Ds, Ds, Dd, Dd, Re, Re, Dd, Dd, Dd
Ds, Dd^Edp, Dd^Edp, Ds, Dd^Ftd, Dd, Dd, Dd, Dd, Ds, Hd^Fts, Dd^Ftd, Dd^Ftd, Gd^Efm, Dd^Ftd, Gd, Dd^Ftd, Gd, Dd, Rd, Dd, Hd^Fts, Hd^Fts, Dd, Dd, Dd, Hd, Hd, Hd, Hd, Hd, Hd, Dd, Hd, Dd, Rd, Re, Ds, Dd, Ds, Dd, Rd, Hd, Hd, Hd, Hd, Dd, Dd, Dd, Dd, Dd, Dd^Esd, Dd, Dd, Dd, Ds, Dd, Ds, Dd, Hd, Hd, Re, Re, Re, Hd, Hd
Dd^Edp, Dd^Edp, Ds, Ds, Dd^Ftd, Ds, Dd, Dd, Dd, Hd^Fts, Dd, Hd^Fts, Gd, Gs, Gd, Dd^Ftd, Hd^Fts, Hd^Fts, Dd, Re, Dd, Hd^Fts, Hd^Fts, Hd^Fts, Hd, Dd, Dd^Edt, Dd, Hd, Ds, Hd, Dd, Hd, Dd, Dd, Ds, Re, Re, Dd, Ds, Ds, Hd, Hd, Hd, Dd, Dd, Dd, Dd, Dd, Dd^Vdt, Dd, Dd, Dd, Hd, Dd, Dd, Ds, Ds, Dd, Dd, Hd, Hd, Re, Re, Re, Re
Ds, Ds, Dd^Edp, Ds, Dd^Vdt, Ds, Dd, Dd, Dd, Dd, Dd, Dd, Dd, Dd, Dd, Dd, Dd, Dd, Re, Re, Dd, Dd, Dd, Dd^Edp, Dd^Edt, Dd, Dd^Edt, Dd^Edp, Dd^Edt, Dd, Ds, Dd, Dd, Rd, Dd, Ds, Re, Rd, Ds, Ds, Re, Rd, Dd, Rd, Dd, Hd, Dd, Dd, Dd, Dd, Dd^Esd, Hd, Dd, Hd, Hd, Dd, Ds, Dd, Dd, Dd, Hd, Hd, Hd, Hd, Re, Hd
Ds, Ds, Ds, Ds, Dd, Dd, Dd, Dd, Dd^Ftd, Dd^Ftd, Dd, Dd, Dd, Dd, Dd, Dd^Vdt, Dd, Dd^Edp, Re, Re, Dd, Dd, Dd, Dd, Dd, Dd, Dd^Edt, Dd^Edp, Dd, Dd, Dd, Rd, Dd, Ds, Re, Re, Re, Re, Ds, Re, Re, Rd, Rd, Dd, Dd, Hd, Dd, Ds^Esd, Dd, Dd, Dd, Dd, Hd, Hd, Dd, Hd, Dd, Dd^Rusy, Dd, Dd^Rusy, Dd, Dd, Dd^Rusy, Dd, Dd, Dd
Dd, Ds, Dd, Dd, Dd, Dd, Re, Rd, Re, Re, Re, Re, Rd, Dd^Edt, Rd, Dd, Rd, Rd, Dd^Edp, Dd^Edp, Ce, Ce, Ce, Dd, Dd, Dd, Dd, Dd, Dd, Dd, Dd, Re, Re, Re, Re, Re, Rd, Re, Rd, Re, Re, Rd, Ds, Ds, Hd, Hd, Hd, Ds, Dd, Hd, Hd, Hd, Hd, Dd, Dd, Ds, Dd^Rusy, Dd^Rusy, Dd^Rusy, Dd^Rusy, Ds, Dd, Dd, Ds, Dd^Rusy, Ds
Rd, Dd, Re, Dd, Re, Rd, Re, Re, Dd, Re, Dd, Re, Dd^Edt, Rd, Dd, Dd, Dd, Dd, Dd^Edp, Dd, Ce, 1 Ket, Ce, Dd, Dd, Dd, Dd, Dd, Dd, Dd, Dd^Edp, Dd, Dd, Dd, Rd, Rd, Re, Rd, Re, Re, Re, Ds, Ds, Ds, Hd, Hd^Fts, Hd^Fts, Hd, Dd, Dd, Dd, Dd, Dd, Ds, Dd^Rusy, Dd^Rusy, Dd^Rusy, Dd^Rusy, Dd^Rusy, Dd^Rusy, Dd^Rusy, Dd^Rusy, Dd^Rusy, Dd^Rusy, Dd^Rusy, Ds
Dd, Rd, Hd, Re, Dd, Re, Dd, Dd^Edp, Dd^Edp, Dd^Edp, Dd, Dd, Dd, Dd, Dd, Dd, Dd, Dd, Dd^Edt, Dd, Dd, Ce, Dd, Dd, Dd^Edp, Dd^Edp, Dd^Edp, Dd^Edp, Dd^Edp, Dd, Dd, Dd^Edp, Dd^Edp, Rd, Rd, Rd, Re, Re, Re, Re, Ds, Dd, Ds, Dd, Dd, Hd, Hd^Fts, Hd, Dd, Dd, Dd, Dd, Ds, Ds, Ds, Dd^Rusy, Dd^Rusy, Dd^Rusy, Dd^Rusy, Dd^Rusy, Dd^Rusy, Dd^Rusy, Dd^Rusy, Ds, Dd^Rusy, Dd
Hd, Hd, Hd, Hd, Dd, Dd, Dd, Dd, Dd^Edp, Dd^Edp, Dd, Dd, Dd^Rusy, Dd, Dd, Dd^Rusy, Dd, Dd, Dd, Dd, Dd, Dd, Dd, Dd, Dd^Edp, Dd^Edp, Dd^Edp, Dd^Edp, Dd^Edp, Dd^Edp, Dd^Vdt, Dd^Edp, Dd, Rd, Re, Re, Re, Ds, Re, Ds, Ds, Ds, Dd, Dd, Hd, Hd^Fts, Hd^Fts, Hd, Dd, Dd, Dd, Dd^Rusy, Ds, Ds, Dd^Rusy, Dd^Rusy, Dd^Rusy, Dd^Rusy, Dd^Rusy, Dd^Rusy, Dd^Rusy, Dd^Rusy, Dd^Rusy, Ds, Dd^Rusy, Ds
Hd, Hd, Dd^Edp, Dd^Edp, Dd^Edp, Dd^Edp, Dd, Dd, Dd, Dd, Dd, Dd^Rusy, Dd^Rusy, Dd, Dd, Dd, Dd, Dd, Dd, Dd^Vdt, Dd, Ds, Dd, Ds, Dd, Rd, Dd, Dd, Hd, Hd, Hd, Re, Rd, Rd, Rd, Re, Ds, Ds, Ds, Ds, Ds, Dd, Dd, Dd, Hd, Hd, Hd, Hd, Ds, Dd^Rusy, Dd^Rusy, Ds, Dd^Rusy, Dd^Rusy, Dd^Rusy, Dd^Rusy, Dd^Rusy, Dd^Rusy, Dd^Rusy, Dd^Rusy, Dd, Dd, Dd^Rusy, Dd^Rusy, Ds, Ds
Hd, Hd, Hd, Dd^Edp, Hd, Dd^Edp, Dd, Dd^Edp, Dd, Dd, Dd, Dd, Dd, Dd^Rusy, Dd, Dd, Dd, Dd, Dd, Dd, Dd, Ds, Ds, Ds, Ds, Rd, Rd, Rd, Hd, Re, Re, Re, Rd, Rd, Re, Re, Dd, Dd, Dd, Dd, Dd, Hd, Hd, Hd, Dd, Hd, Hd, Dd, Ds, Dd^Rusy, Ds, Dd^Rusy, Ds, Dd, Dd, Dd^Rusy, Dd^Rusy, Dd, Ds, Ds, Dd^Edp, Dd, Dd, Dd, Ds^Esd, Ds^Esd
Hd, Hd, Hd, Hd, Dd, Dd, Dd, Dd, Dd, Dd, Dd, Dd, Dd, Dd, Dd^Edp, Dd^Vdt, Ds, Ds, Ds, Ds, Ds, Rd, Ds, Ds, Ds, Rd, Rd, Rd, Rd, Re, Re, Re, Rd, Rd, Rd, Rd, Rd, Dd, Dd, Dd, Dd, Dd, Hd, Hd, Dd, Dd, Dd, Dd, Ds, Ds, Ds, Ds, Dd, Dd, Dd, Dd^Edp, Dd, Dd^Edp, Ds, Hd^Fts, Ds^Edp, Dd, Dd, Dd, Ds, Ds
