Xzg, Xzg, Xzg, Xzg, Xzg, Xzg, Xzg, Xzg, Xzg, Xzg, Xzg, Xzg, Xzg, Xzg, Xzg, Xzg, Xzg, Xzg, Xzg, Xzg, Xzg, Xzg, Xzg, Xzg, Xzg, Xzg, Xzg, Xzg, Xzg, Xzg, Xzg, Xzg, Xzg, Xzg, Xzg, Xzg, Xzg, Xzg, Xzg, Xzg, Xzg, Xzg, Xzg, Xzg, Xzg, Xzg, Xzg, Xzg, Xzg, Xzg, Xzg, Xzg, Xzg, Xzg, Xzg
Xzg, Xzg, Xzg, Xzg, Xzg, Xzg, Xzg, Xzg, Xzg, Xzg, Xzg, Xzg, Xzg, Xzg, Xzg^Edp, Xzg, Xzg, Xzg, Xzg, Xzg, Xzg, Xzg, Xzg, Xzg, Xzg, Xzg, Xzg, Xzg, Xzg, Xzg, Xzg^Edb, Xzg^Edb, Xzg, Xzg, Xzg, Xzg, Xzg, Xzg, Xzg, Xzg, Xzg, Xzg, Xzg, Xzg, Xzg, Xzg, Xzg, Xzg, Xzg, Xzg, Xzg, Xzg, Xzg, Xzg, Xzg
Xzg, Xzg, Xzg, Xzg^Rusy, Xzg^Rusy, Xzg, Xzg, Xzg^Rusy, Xzg^Edb, Xzg, Xzg, Xzg, Xzg, Xzg^Edp, Xzg^Edp, Xzg, Xzg, Xzg, Xzg, Xzg, Xzg, Xzg, Xzg, Xzg, Xzg, Xzg, Xzg, Xzg, Xzg, Xzg, Xzg^Edb, Xzg, Xzg, Xzg, Xzg^Rusy, Xzg^Edp, Xzg^Rusy, Xzg, Xzg, Xzg^Rusy, Xzg^Rusy, Xzg, Xzg, Xzg, Xzg, Xzg, Xzg, Xzg, Xzg, Xzg, Xzg, Xzg, Xzg, Xzg, Xzg
Xzg, Xzg, Xzg, Xzg, Xzg^Rusy, Xzg, Xzg, Xzg^Edb, Xzg^Edb, Xzg, Xzg, Xzg^Edp, Xzg, Xzg^Edp, Xzg, Xzg, Xzg, Xzg, Xzg, Xzg, Xzg, Xzg, Xzg, Xzg, Xzg, Xzg, Xzg, Xzg, Xzg, Xzg^Edb, Xzg^Edb, Xzg^Edb, Xzg, Xzg, Xzg, Xzg^Rusy, Xzg^Rusy, Xzg^Edp, Xzg^Rusy, Xzg^Rusy, Xzg, Xzg, Xzg^Edp, Xzg, Xzg^Edp, Xzg^Edp, Xzg, Xzg, Xzg, Xzg, Xzg, Xzg, Xzg, Xzg, Xzg
Xzg, Xzg, Xzg^Rusy, Xzg^Rusy, Xzg^Rusy, Xzg^Rusy, Xzg^Edb, Xzg^Edb, Xzg, Xzg, Xzg, Xzg^Edp, Xzg^Edp, Xzg, Xzg, Xzg, Xzg, Xzg, Xzg^Edp, Xzg^Edp, Xzg^Edp, Xzg, Xzg, Xzg, Xzg^Edp, Xzg, Xzg, Xzg, Xzg, Xzg, Xzg, Xzg, Xzg^Rusy, Xzg^Rusy, Xzg^Rusy, Xzg^Rusy, Xzg, Xzg^Edp, Xzg, Xzg^Edp, Xzg^Edp, Xzg^Edp, Xzg, Xzg^Edp, Xzg^Edp, Xzg^Edp, Xzg, Xzg, Xzg, Xzg, Xzg^Rusy, Xzg, Xzg, Xzg, Xzg
Xzg, Xzg, Xzg, Xzg, Xzg^Rusy, Xzg^Rusy, Xzg^Rusy, Xzg, Xzg, Xzg, Xzg^Edp, Xzg^Edp, Xzg^Edp, Xzg^Edp, Xzg, Xzg, Xzg^Edp, Xzg, Xzg^Edp, Xzg, Xzg^Edp, Xzg, Xzg, Xzg, Xzg, Xzg, Xzg, Xzg, Xzg, Xzg, Xzg, Xzg, Xzg, Xzg^Rusy, Xzg^Rusy, Xzg^Rusy, Xzg, Xzg, Xzg^Edp, Xzg, Xzg^Edp, Xzg^Edp, Xzg^Edp, Xzg^Edp, Xzg^Edp, Xzg, Xzg, Xzg, Xzg^Rusy, Xzg^Rusy, Xzg, Xzg, Xzg^Edb, Xzg, Xzg
Xzg, Xzg, Xzg, Xzg, Xzg, Xzg^Rusy, Xzg, Xzg, Xzg, Xzg, Xzg^Edp, Xzg, Xzg^Rusy, Xzg, Xzg^Rusy, Xzg, Xzg, Xzg^Edp, Xzg, Xzg, Xzg, Xzg, Xzg, Xzg, Xzg^Edp, Xzg^Edp, Xzg, Xzg, Xzgg, Xzg, Xzg, Xzg, Xzg, Xzg, Xzg, Xzg, Xzg^Edp, Xzg, Xzgg^Edp, Xzg, Xzg^Edp, Xzg^Edp, Xzg^Edp, Xzg^Edp, Xzg^Edp, Xzg, Xzg^Edp, Xzg^Rusy, Xzg^Rusy, Xzg^Rusy, Xzg^Edb, Xzg^Edb, Xzg^Edb, Xzg, Xzg
Xzg, Xzg, Xzg, Xzg, Xzg, Xzg, Xzg, Xzg^Edp, Xzg, Xzg, Xzg, Xzg^Rusy, Xzg^Rusy, Xzg^Rusy, Xzg^Rusy, Xzg^Rusy, Xzg^Rusy, Xzg, Xzg, Xzg^Edp, Xzg, Xzg^Edp, Xzg^Edp, Xzg, Xzg, Xzg, Xzg, Xzg, Xzgg, Xzgg, Xzgg, Xzgg, Xzgg, Xzg, Xzg, Xzg, Xzg, Xzg, Xzgg^Edp, Xzgg, Xzg, Xzg, Xzg^Edp, Xzg^Edp, Xzg, Xzg, Xzg^Rusy, Xzg, Xzg^Rusy, Xzg^Rusy, Xzg, Xzg, Xzg, Xzg, Xzg
Xzg, Xzg, Xzg^Edp, Xzg^Edp, Xzg^Edp, Xzg^Edp, Xzg^Edp, Xzg, Xzg, Xzg, Xzg^Rusy, Xzg^Rusy, Xzg^Rusy, Xzg^Rusy, Xzg^Rusy, Xzg^Rusy, Xzg^Rusy, Xzg, Xzg, Xzgg, Xzg, Xzg, Xzgg, Xzg, Xzgg, Xzg, Xzgg, Xzgg, Xzg2, Xzgg, Xzgg, Xzgg, Xzg2, Xzgg, Xzg, Xzg, Xzgg, Xzgg, Xzgg, Xzgg^Edp, Xzgg, Xzg^Edp, Xzg, Xzg, Xzg, Xzg^Rusy, Xzg^Rusy, Xzg^Rusy, Xzg^Rusy, Xzg^Rusy, Xzg^Rusy, Xzg, Xzg, Xzg, Xzg
Xzg, Xzg, Xzg, Xzg^Edp, Xzg^Edp, Xzg^Edp, Xzg^Edp, Xzg, Xzg, Xzg, Xzg, Xzg, Xzg, Xzg, Xzg, Xzg^Rusy, Xzg, Xzg, Xzg^Esd, Xzg, Xzgg^Esd, Xzgg^Edp, Xzgg^Edp, Xzgg, Xzg2, Xzgg, Xzg2, Xzg2, Xzg3^Qov, Xzg2, Xzg2, Xzg2, Xzg2, Xzgg, Xzgg, Xzgg, Xzg2, Xzgg, Xzgg, Xzgg, Xzgg, Xzg, Xzg, Xzg, Xzg^Rusy, Xzg, Xzg, Xzg^Rusy, Xzg, Xzg^Rusy, Xzg, Xzg, Xzg, Xzg, Xzg
Xzg, Xzg^Edp, Xzg^Edp, Xzg^Edp, Xzg^Edp, Xzg^Edp, Xzg^Edp, Xzg, Xzg, Xzg^Rusy, Xzg^Rusy, Xzg^Es, Xzg, Xzg, Xzg, Xzg, Xzg^Edp, Xzg^Esd, Xzg, Xzgg, Xzg2^Edp, Xzgg^Edp, Xzg2^Edp, Xzg2, Xzg3^Qov, Xzg2, Xzg3^Edp, Xzg3^Edp, Xzg3^Qov, Xzg3^Qov, Xzg3^Qov, Xzg3^Qov, Xzg3^Qov, Xzg2, Xzg2, Xzg2, Xzg3^Qov, Xzg2, Xzgg, Xzgg, Xzgg, Xzg, Xzg^Rusy, Xzg^Rusy, Xzg, Xzg, Xzg, Xzg^Rusy, Xzg^Rusy, Xzg, Xzg, Xzg^Rusy, Xzg, Xzg, Xzg
Xzg, Xzg, Xzg^Edp, Xzg^Edp, Xzg, Xzg, Xzg^Edp, Xzg, Xzg, Xzg^Rusy, Xzg, Xzg, Xzg^Edp, Xzg^Edp, Xzg^Edp, Xzg^Edp, Xzg, Xzg, Xzgg, Xzgg, Xzg2, Xzg2^Edp, Xzg3^Qov, Xzg3^Edp, Xzg3^Edp, Xzg3^Edp, Xzg3^Qov, Xzg3^Edp, Xzg3^Qov, Xzg4^Qov, Xzg4^Qov, Xzg3^Qov, Xzg3^Qov, Xzg3^Qov, Xzg3^Qov, Xzg3^Esd, Xzg3^Esd, Xzg2, Xzg2, Xzgg, Xzgg, Xzg, Xzg, Xzg, Xzg, Xzg^Rusy, Xzg, Xzg, Xzg, Xzg^Rusy, Xzg, Xzg, Xzg, Xzg, Xzg
Xzg, Xzg, Xzg, Xzg, Xzg^Edp, Xzg^Edp, Xzg, Xzg, Xzg, Xzg, Xzg, Xzg, Xzg^Edp, Xzg, Xzgg, Xzgg, Xzgg, Xzgg, Xzgg, Xzgg, Xzg2, Xzg3^Qov, Xzg3^Qov, Xzg3^Edp, Xzg3^Qov, Xzg3^Edp, Xzg4^Qov, Xzg3^Qov, Xzg4^Qov, Xzg4^Qov, Xzg4^Qov, Xzg3^Qov, Xzg4^Qov, Xzg3^Edp, Xzg4^Qov, Xzg3^Qov, Xzg3^Edp, Xzg3^Edp, Xzg3^Edp, Xzg2, Xzg2, Xzgg, Xzgg, Xzg, Xzgg, Xzgg, Xzgg, Xzg, Xzg, Xzg, Xzg, Xzg, Xzg, Xzg^Rusy, Xzg
Xzg, Xzg, Xzg^Edp, Xzg^Edp, Xzg, Xzg, Xzg, Xzg, Xzg, Xzg, Xzgg, Xzg^Edp, Xzg^Esd, Xzg, Xzgg, Xzg2, Xzg2, Xzg2, Xzg2^Es, Xzg2, Xzg3^Qov, Xzg3^Qov, Xzg4^Qov, Xzg4^Qov, Xzg4^Qov, Xzg4^Qov, Xzg5^Qov, Xzg4^Qov, Xzg5^Qov, Xzg5^Qov, Xzg5^Qov, Xzg4^Qov, Xzg4^Qov, Xzg4^Edp, Xzg4^Edp, Xzg4^Qov, Xzg3^Edp, Xzg3^Qov, Xzg3^Edp, Xzg2, Xzg2, Xzgg, Xzgg^Edp, Xzgg^Edp, Xzgg, Xzgg, Xzg2, Xzgg, Xzgg^Edp, Xzg, Xzg, Xzg, Xzg, Xzg, Xzg
Xzg^Edp, Xzg^Edp, Xzg^Edp, Xzg^Edp, Xzg, Xzg, Xzg, Xzg, Xzgg, Xzgg, Xzg2^Edp, Xzgg^Edp, Xzgg, Xzgg, Xzgg, Xzg2, Xzg2, Xzg3^Qov, Xzg3^Qov, Xzg3^Qov, Xzg3^Qov, Xzg3^Edp, Xzg3^Edp, Xzg4^Edp, Xzg5^Edp, Xzg4^Qov, Xzg5^Qov, Xzg5^Qov, Xzg5^Qov, Dd^Qov, Dd^Qov, Xzg5^Qov, Xzg5^Qov, Xzg4^Qov, Xzg5^Qov, Xzg4^Edp, Xzg4^Qov, Xzg4^Qov, Xzg3^Edp, Xzg3^Edp, Xzg2, Xzg2, Xzg2, Xzgg^Edp, Xzg2, Xzg2, Xzg2, Xzgg, Xzgg^Edp, Xzg, Xzg, Xzg^Edp, Xzg^Edp, Xzg, Xzg
Xzg, Xzg^Edp, Xzg, Xzg, Xzg, Xzg, Xzgg, Xzg, Xzgg, Xzgg^Edp, Xzg2^Edp, Xzg2^Edp, Xzg2, Xzgg, Xzg2, Xzg2, Xzg2, Xzg3^Qov, Xzg3^Qov, Xzg3^Qov, Xzg4^Qov, Xzg3^Qov, Xzg4^Qov, Xzg4^Edp, Xzg5^Qov, Xzg5^Qov, Xzg5^Qov, Dd, Dd, Dd^Qov, Dd^Qov, Dd^Qov, Xzg5^Qov, Xzg5^Qov, Xzg5^Qov, Xzg4^Qov, Xzg5^Qov, Xzg4^Qov, Xzg4^Edp, Xzg3^Edp, Xzg3^Edp, Xzg2, Xzg2, Xzg2, Xzg2^Edp, Xzg2^Edp, Xzg2^Edp, Xzgg^Edp, Xzgg, Xzg, Xzg, Xzg, Xzg^Edp, Xzg, Xzg
Xzg, Xzg, Xzg, Xzg, Xzg, Xzgg, Xzg2, Xzgg, Xzg2, Xzg2^Edp, Xzg3^Qov, Xzg3^Edp, Xzg3^Edp, Xzg2, Xzg2, Xzg2, Xzg3^Qov, Xzg3^Edp, Xzg3^Edp, Xzg4^Qov, Xzg2, Xzg4^Qov, Xzg5^Qov, Xzg5^Qov, Xzg5^Qov, Dd, Dd, Dd, Xzg5^Qov, Dd^Qov, Dd^Ruty, Dd^Qov, Dd, Dd, Xzg5^Qov, Xzg5^Qov, Dd, Xzg5^Qov, Xzg5^Qov, Xzg4^Qov, Xzg3^Qov, Xzg3^Qov, Xzg3^Edp, Xzg3^Qov, Xzg3^Edp, Xzg3^Qov, Xzg2^Qov, Xzgg^Edp, Xzgg^Edp, Xzg, Xzg^Edp, Xzg, Xzg, Xzg, Xzg
Xzg, Xzg, Xzg, Xzgg, Xzgg, Xzgg, Xzgg, Xzg2^Es, Xzg2^Es, Xzg3^Qov, Xzg3^Qov, Xzg3^Edp, Xzg3^Qov, Xzg3^Edp, Xzg3^Qov, Xzg3^Qov, Xzg3^Edp, Xzg3^Edp, Xzg3^Qov, Xzg4^Qov, Xzg4^Qov, Xzg4^Qov, Xzg5^Qov, Dd^Es, Dd^Es, Dd, Dd, Xzg5^Qov, Dd, Dd^Qov, Dd^Qov, Dd^Qov, Dd^Rusy, Dd, Dd, Dd^Es, Dd^Es, Xzg5^Qov, Xzg4^Qov, Xzg4^Qov, Xzg3^Qov, Xzg3^Qov, Xzg3^Qov, Xzg3^Qov, Xzg4^Qov, Xzg3^Qov, Xzg3^Qov, Xzg2^Qov, Xzg2^Edp, Xzgg, Xzg, Xzg, Xzg, Xzg, Xzg
Xzg, Xzg, Xzgg, Xzgg, Xzg2, Xzg2, Xzg2, Xzg2, Xzg3^Qov, Xzg3^Qov, Xzg3^Qov, Xzg3^Qov, Xzg4^Qov, Xzg3^Qov, Xzg4^Qov, Xzg3^Qov, Xzg3^Edp, Xzg4^Edp, Xzg4^Qov, Xzg4^Edp, Xzg5^Qov, Xzg5^Qov, Xzg5^Qov, Dd^Es, Dd, Dd^Es, Rd, Dd^Rusy, Dd^Rusy, Dd^Rusy, Dd^Rusy, Dd^Rusy, Dd^Rusy, Dd, Xzg5^Qov, Dd^Es, Dd, Xzg5^Qov, Xzg5^Qov, Xzg4^Qov, Xzg4^Edp, Xzg4^Qov, Xzg3^Qov, Xzg3^Qov, Xzg4^Qov, Xzg3^Qov, Xzg3^Qov, Xzg3^Qov, Xzg2^Edp, Xzgg^Edp, Xzgg^Edp, Xzg, Xzg, Xzg, Xzg
Xzg, Xzg, Xzgg, Xzg2, Xzg2^Edp, Xzg3^Edp, Xzg3^Qov, Xzg3^Qov, Xzg4^Qov, Xzg4^Qov, Xzg4^Qov, Xzg3^Qov, Xzg4^Qov, Xzg4^Qov, Xzg5^Qov, Xzg4^Qov, Xzg3^Qov, Xzg3^Qov, Xzg4^Qov, Xzg4^Qov, Xzg5^Qov, Xzg5^Qov, Xzg5^Qov, Xzg5^Qov, Dd, Dd, Dd, Rd^Rusy, Re^Rusy, Rd, 3 Re, Rd, Dd^Es, Dd, Dd, Dd, Xzg5^Qov, Dd, Xzg5^Qov, Xzg4^Qov, Xzg4^Qov, Xzg4^Edp, Xzg4^Qov, Xzg4^Qov, Xzg5^Qov, Xzg4^Qov, Xzg4^Qov, Xzg3^Edp, Xzg3^Edp, Xzg2, Xzg2^Edp, Xzgg, Xzgg^Edp, Xzg, Xzg
Xzg, Xzgg, Xzgg, Xzg2^Edp, Xzg2, Xzg3^Edp, Xzg3^Edp, Xzg3^Qov, Xzg4^Qov, Xzg5^Qov, Xzg5^Edp, Xzg4^Qov, Xzg5^Qov, Xzg5^Qov, Xzg4^Qov, Xzg4^Qov, Xzg4^Qov, Xzg4^Qov, Xzg5^Qov, Xzg5^Qov, Dd^Qov, Dd^Qov, Dd^Qov, Dd, Xzg5^Qov, Xzg5^Qov, Dd^Es, Dd, Rd^Es, Re, Re, Rd^Es, Rd, Rd, Dd^Rusy, Dd, Dd, Dd, Dd^Qov, Xzg5^Qov, Xzg4^Qov, Xzg4^Edp, Xzg5^Qov, Xzg5^Qov, Xzg3, Xzg5^Qov, Xzg4^Qov, Xzg3^Edp, Xzg3^Edp, Xzg2^Edp, Xzg2^Edp, Xzg2^Edp, Xzgg, Xzg, Xzg
Xzgg, Xzg, Xzgg, Xzg2^Edp, Xzg3^Qov, Xzg3^Qov, Xzg4^Qov, Xzg4^Qov, Xzg4^Qov, Xzg5^Qov, Xzg5^Qov, Xzg5^Edp, Xzg5^Qov, Xzg4^Qov, Xzg4^Edp, Xzg4^Edp, Xzg4^Qov, Xzg5^Qov, Dd, Xzg5^Qov, Dd^Qov, Dd^Ruty, Re^Qov, Dd, Xzg5^Qov, Dd, Rd, Dd, Rd^Es, Re, Re, Re, Re, Re, Rd^Rusy, Dd, Rd, Dd^Qov, Xzg5^Qov, Xzg5^Qov, Xzg4^Qov, Xzg4^Qov, Xzg5^Qov, Xzg3, Xzg3, Xzg5^Qov, Xzg5^Qov, Xzg4^Edp, Xzg4^Edp, Xzg3^Qov, Xzg3^Edp, Xzg2, Xzg2, Xzgg, Xzg
Xzgg, Xzgg, Xzg2^Es, Xzg2^Es, Xzg3^Qov, Xzg4^Qov, Xzg4^Qov, Xzg5^Qov, Xzg5^Qov, Xzg4^Qov, Xzg4^Qov, Xzg5^Qov, Xzg5^Qov, Xzg4^Qov, Xzg4^Qov, Xzg4^Qov, Xzg5^Qov, Xzg5^Qov, Dd^Es, Dd^Es, Dd, Re^Qov, Dd, Dd, Dd, Dd, Dd, Rd, Rd, Rd, 2 Re, Rd, Dd, Dd, Dd^Rusy, Dd^Rusy, Re^Rusy, Dd^Qov, Dd^Ruty, Xzg5^Qov, Xzg5^Qov, Xzg5^Qov, Xzg5^Edp, Xzg3, Xzg3^Edp, Xzg3, Xzg5^Qov, Xzg5^Qov, Xzg4^Qov, Xzg3^Edp, Xzg3^Qov, Xzg2, Xzg2, Xzgg, Xzg
Xzgg, Xzgg, Xzg2, Xzg2, Xzg3^Qov, Xzg4^Qov, Xzg5^Qov, Xzg5^Qov, Xzg5^Edp, Xzg4^Qov, Xzg4^Qov, Xzg4^Qov, Xzg5^Qov, Xzg4^Qov, Xzg4^Qov, Xzg5^Qov, Xzg5^Qov, Xzg5^Qov, Xzg5^Qov, Xzg5^Qov, Dd, Rd, Dd, Xzg5^Qov, Dd, Dd^Es, Dd, Rd, Dd^Es, Dd, Rd, Re, Re, Dd, Dd, Re^Rusy, Dd^Rusy, Rd^Qov, Dd^Qov, Dd^Qov, Xzg5^Qov, Xzg5^Qov, Xzg4^Qov, Xzg5^Qov, Xzg5^Edp, Xzg5^Qov, Xzg5^Qov, Xzg4^Qov, Xzg3^Qov, Xzg3^Qov, Xzg2, Xzg2, Xzgg, Xzgg, Xzg
Xzgg, Xzg2, Xzg2, Xzg3^Esd, Xzg4^Qov, Xzg4^Qov, Xzg5^Qov, Xzg5^Edp, Xzg5^Edp, Xzg5^Qov, Xzg4^Qov, Xzg5^Qov, Xzg5^Qov, Xzg4^Qov, Xzg4^Qov, Xzg4^Qov, Xzg4^Edp, Xzg4^Qov, Xzg4^Qov, Xzg5^Qov, Xzg5^Qov, Dd, Dd, Dd, Rd, Dd^Es, Re, 1 Dd^Es, Re, Dd, Dd, Dd, Dd, Dd, Dd, Dd, Dd, Dd, Xzg5^Qov, Dd, Xzg5^Qov, Xzg4^Qov, Xzg4^Edp, Xzg4^Qov, Xzg4^Qov, Xzg4^Qov, Xzg4^Qov, Xzg4^Qov, Xzg3^Qov, Xzg2, Xzgg, Xzgg, Xzg, Xzgg, Xzg
Xzgg, Xzgg, Xzg2, Xzg3^Qov, Xzg3^Qov, Xzg4^Qov, Xzg4^Qov, Xzg5^Qov, Xzg5^Edp, Xzg5^Edp, Xzg5^Qov, Xzg4^Qov, Xzg5^Qov, Xzg5^Qov, Xzg4^Qov, Xzg3^Qov, Xzg4^Qov, Xzg4^Qov, Xzg4^Qov, Xzg5^Qov, Dd, Dd, Xzg5^Qov, Dd, Dd^Es, Re, Dd, Re, Re, Rd, Dd^Rusy, Dd, Xzg5^Qov, Dd, Dd, Dd, Xzg5^Qov, Xzg5^Qov, Xzg5^Qov, Xzg5^Qov, Xzg4^Qov, Xzg4^Qov, Xzg3^Qov, Xzg3^Qov, Xzg3^Qov, Xzg3^Qov, Xzg3^Qov, Xzg3^Qov, Xzg3^Qov, Xzg2, Xzgg^Edp, Xzgg, Xzg, Xzg, Xzg
Xzgg, Xzgg, Xzg2^Es, Xzg3^Edp, Xzg3^Qov, Xzg4^Qov, Xzg4^Qov, Xzg5^Edp, Xzg5^Edp, Xzg5^Edp, Xzg5^Qov, Xzg4^Qov, Xzg4^Qov, Xzg4^Qov, Xzg4^Qov, Xzg3^Qov, Xzg3^Qov, Xzg3^Qov, Xzg4^Edp, Xzg5^Qov, Xzg5^Qov, Dd, Xzg5^Qov, Dd, Dd, Dd^Es, Dd^Es, Dd, Dd, Dd, Dd, Dd, Dd^Es, Dd, Dd, Dd, Dd, Xzg5^Qov, Xzg4^Qov, Xzg4^Qov, Xzg4^Edp, Xzg4^Edp, Xzg3^Qov, Xzg3^Edp, Xzg3^Qov, Xzg3^Qov, Xzg3^Esd, Xzg3^Qov, Xzg3^Qov, Xzg2^Edp, Xzg2, Xzgg, Xzg, Xzg, Xzg
Xzgg, Xzg2, Xzg2^Es, Xzg3^Edp, Xzg3^Edp, Xzg4^Edp, Xzg4^Edp, Xzg4^Qov, Xzg4^Qov, Xzg5^Edp, Xzg4^Qov, Xzg5^Qov, Xzg4^Qov, Xzg4^Edp, Xzg3^Qov, Xzg3^Qov, Xzg4^Qov, Xzg4^Qov, Xzg4^Edp, Xzg5^Qov, Xzg5^Qov, Xzg5^Qov, Xzg5^Qov, Xzg5^Qov, Dd^Es, Dd, Dd, Xzg5^Qov, Dd, Xzg5^Qov, Dd, Dd^Es, Dd^Es, Dd, Xzg5^Qov, Dd, Dd, Xzg5^Qov, Xzg4^Qov, Xzg4^Qov, Xzg3^Qov, Xzg3^Edp, Xzg3^Edp, Xzg3^Qov, Xzg2^Qov, Xzg2^Qov, Xzg2^Qov, Xzg3^Edp, Xzg2^Qov, Xzg2, Xzgg, Xzgg, Xzg, Xzg, Xzg
Xzgg, Xzg2, Xzg2, Xzg3^Qov, Xzg3^Qov, Xzg3^Qov, Xzg3^Qov, Xzg4^Qov, Xzg3^Qov, Xzg4^Qov, Xzg4^Qov, Xzg4^Qov, Xzg4^Qov, Xzg4^Qov, Xzg3^Qov, Xzg3^Qov, Xzg4^Qov, Xzg4^Edp, Xzg4^Edp, Xzg4^Edp, Xzg4^Qov, Xzg4^Qov, Xzg5^Qov, Xzg5^Qov, Xzg5^Qov, Dd^Es, Xzg5^Qov, Dd, Dd, Dd, Xzg5^Qov, Dd^Es, Xzg5^Qov, Xzg5^Qov, Xzg4^Qov, Xzg5^Qov, Xzg5^Qov, Xzg5^Qov, Xzg5^Es, Xzg4^Qov, Xzg4^Edp, Xzg3^Qov, Xzg3^Edp, Xzg2^Qov, Xzg2, Xzg2^Esd, Xzg2, Xzg2^Qov, Xzgg^Edp, Xzgg^Edp, Xzgg, Xzgg, Xzg, Xzg, Xzg
Xzg, Xzgg, Xzgg, Xzg2, Xzg2, Xzg3^Qov, Xzg3^Qov, Xzg3^Qov, Xzg3^Edp, Xzg3^Qov, Xzg3^Edp, Xzg3^Qov, Xzg3^Qov, Xzg3^Qov, Xzg3^Qov, Xzg3^Qov, Xzg3^Qov, Xzg4^Qov, Xzg3^Qov, Xzg4^Qov, Xzg3^Qov, Xzg4^Qov, Xzg4^Qov, Xzg5^Qov, Xzg4^Qov, Xzg5^Qov, Xzg5^Qov, Xzg5^Qov, Xzg5^Qov, Xzg5^Qov, Xzg4^Qov, Xzg5^Qov, Xzg5^Qov, Xzg5^Qov, Xzg4, Xzg5^Es, Xzg5^Es, Xzg5^Edp, Xzg4^Qov, Xzg4^Qov, Xzg4^Edp, Xzg3^Edp, Xzg3^Edp, Xzg2^Qov, Xzg2^Edp, Xzg2^Edp, Xzg2^Edp, Xzgg^Edp, Xzgg^Edp, Xzgg^Edp, Xzgg, Xzg, Xzg, Xzg, Xzg
Xzg, Xzgg, Xzgg, Xzg2, Xzg2^Edp, Xzg3^Qov, Xzg3^Edp, Xzg3^Qov, Xzg3^Qov, Xzg3^Qov, Xzg3^Qov, Xzg3^Edp, Xzg3, Xzg3^Edp, Xzg3, Xzg3^Qov, Xzg3^Qov, Xzg3^Qov, Xzg3^Qov, Xzg3^Qov, Xzg4^Edp, Xzg4^Qov, Xzg4^Edp, Xzg4^Qov, Xzg4^Qov, Xzg4^Qov, Xzg4^Qov, Xzg4^Qov, Xzg4^Qov, Xzg4^Qov, Xzg3^Qov, Xzg4^Qov, Xzg4^Qov, Xzg4^Qov, Xzg4^Qov, Xzg4^Qov, Xzg4^Qov, Xzg4^Qov, Xzg4^Qov, Xzg4^Qov, Xzg3^Qov, Xzg3^Qov, Xzg2^Qov, Xzg2^Qov, Xzg2, Xzg2^Edp, Xzg2^Edp, Xzg2, Xzgg, Xzgg, Xzg, Xzg, Xzg^Edp, Xzg^Edp, Xzg
Xzg, Xzg, Xzgg, Xzg2, Xzg2^Edp, Xzg2^Edp, Xzg2, Xzg2, Xzg2, Xzg3^Qov, Xzg3^Qov, Xzg3^Qov, Xzg2^Edp, Xzg3, Xzg2, Xzg2, Xzg2, Xzg2, Xzg3^Qov, Xzg3^Qov, Xzg3^Qov, Xzg4^Qov, Xzg3^Qov, Xzg4^Edp, Xzg3^Qov, Xzg3^Qov, Xzg4^Qov, Xzg4^Edp, Xzg4^Qov, Xzg3^Qov, Xzg3, Xzg3^Qov, Xzg3^Qov, Xzg4^Qov, Xzg4^Qov, Xzg4^Qov, Xzg4^Qov, Xzg4^Qov, Xzg3^Qov, Xzg3^Qov, Xzg2^Qov, Xzg2^Qov, Xzgg, Xzgg, Xzgg, Xzgg, Xzgg, Xzgg, Xzgg, Xzgg, Xzg, Xzg, Xzg, Xzg^Rusy, Xzg
Xzgg, Xzgg, Xzgg, Xzg2^Edp, Xzgg^Edp, Xzg2, Xzg2, Xzg2, Xzgg, Xzg2, Xzg2, Xzg2, Xzg2^Edp, Xzg2, Xzg2, Xzg2, Xzgg, Xzg2, Xzg2, Xzg3^Qov, Xzg3^Qov, Xzg3^Qov, Xzg3^Qov, Xzg3^Qov, Xzg3^Edp, Xzg3^Qov, Xzg3^Qov, Xzg3^Qov, Xzg3^Qov, Xzg3^Qov, Xzg2^Qov, Xzg3^Edp, Xzg3^Edp, Xzg3^Qov, Xzg3^Edp, Xzg3, Xzg3, Xzg3^Qov, Xzg3^Qov, Xzg3^Qov, Xzg2, Xzgg, Xzgg^Edp, Xzgg, Xzgg^Edp, Xzgg, Xzgg, Xzgg, Xzgg, Xzg, Xzg, Xzg^Rusy, Xzg, Xzg, Xzg
Xzg, Xzg, Xzgg, Xzgg, Xzgg^Edp, Xzgg, Xzgg, Xzgg, Xzg, Xzgg, Xzgg, Xzg2^Edp, Xzgg, Xzgg, Xzgg^Edp, Xzgg, Xzgg, Xzg2, Xzg2, Xzg3^Qov, Xzg3^Esd, Xzg3^Qov, Xzg2, Xzg3^Qov, Xzg3^Edp, Xzg3^Edp, Xzg3^Edp, Xzg3^Qov, Xzg2^Edp, Xzg2, Xzg2^Qov, Xzg3, Xzg3^Edp, Xzg3^Edp, Xzg3^Es, Xzg3^Edp, Xzg2^Qov, Xzg2^Qov, Xzg2^Qov, Xzg3^Qov, Xzg2, Xzgg, Xzgg^Edp, Xzgg^Edp, Xzgg^Edp, Xzgg^Edp, Xzgg^Edp, Xzgg^Rusy, Xzg, Xzg, Xzg, Xzg^Rusy, Xzg^Rusy, Xzg, Xzg
Xzg, Xzg, Xzg, Xzgg, Xzg, Xzgg, Xzg, Xzg, Xzg^Rusy, Xzg, Xzgg, Xzgg, Xzgg, Xzgg, Xzgg^Edp, Xzgg^Edp, Xzgg, Xzgg, Xzg2^Esd, Xzg3^Esd, Xzg2^Esd, Xzg2, Xzgg, Xzg2, Xzg2, Xzg2, Xzg2, Xzg2^Edp, Xzg2^Edp, Xzg2, Xzgg, Xzg2^Qov, Xzg2^Qov, Xzg2^Qov, Xzg2^Qov, Xzg2^Qov, Xzg2^Edp, Xzg2^Edp, Xzg2, Xzg2, Xzg2^Rusy, Xzgg, Xzgg, Xzgg^Edp, Xzgg^Edp, Xzgg, Xzgg^Edp, Xzgg, Xzg, Xzg, Xzg, Xzg, Xzg, Xzg, Xzg
Xzg, Xzg, Xzg, Xzg^Edp, Xzg^Edp, Xzg, Xzg^Rusy, Xzg, Xzg, Xzg^Rusy, Xzg, Xzgg, Xzg, Xzgg^Edp, Xzgg^Edp, Xzgg^Edp, Xzgg, Xzgg, Xzg2^Esd, Xzg2^Esd, Xzgg, Xzgg, Xzgg^Edp, Xzgg, Xzgg, Xzg2, Xzg2^Edp, Xzg2, Xzgg, Xzg2, Xzgg, Xzgg, Xzgg, Xzg2^Edp, Xzg2^Edp, Xzg2^Edp, Xzgg, Xzg2, Xzg2, Xzg2, Xzgg, Xzg2, Xzgg, Xzgg, Xzgg^Edp, Xzgg^Edp, Xzgg, Xzgg^Edp, Xzg, Xzg^Edp, Xzg, Xzg, Xzg^Edp, Xzg, Xzg
Xzg, Xzg, Xzg, Xzg, Xzg, Xzg, Xzg^Rusy, Xzg^Rusy, Xzg^Rusy, Xzg^Rusy, Xzg^Rusy, Xzg, Xzg, Xzg, Xzg, Xzgg, Xzg2, Xzgg, Xzgg, Xzg2, Xzgg, Xzgg, Xzg, Xzgg^Edp, Xzgg, Xzgg, Xzgg, Xzgg, Xzg, Xzgg, Xzgg, Xzgg^Edp, Xzgg, Xzg2^Edp, Xzgg, Xzgg, Xzg^Edp, Xzgg, Xzgg, Xzgg, Xzgg, Xzgg, Xzg, Xzg, Xzg, Xzg, Xzg, Xzgg, Xzgg^Edp, Xzg, Xzg, Xzg, Xzg^Edp, Xzg, Xzg
Xzg, Xzg, Xzg, Xzg, Xzg^Rusy, Xzg^Rusy, Xzg^Rusy, Xzg^Rusy, Xzg^Rusy, Xzg^Rusy, Xzg, Xzg, Xzg, Xzg, Xzg, Xzgg, Xzgg, Xzgg, Xzgg^Rusy, Xzgg, Xzg, Xzg, Xzg, Xzg, Xzg, Xzgg^Edp, Xzg, Xzg, Xzg^Edp, Xzg, Xzg, Xzgg^Edp, Xzg, Xzgg, Xzg, Xzg, Xzg, Xzg, Xzg, Xzg, Xzg, Xzg, Xzg^Rusy, Xzg, Xzg, Xzg, Xzg, Xzgg^Edp, Xzg, Xzg, Xzg^Edp, Xzg, Xzg, Xzg^Edp, Xzg
Xzg, Xzg, Xzg, Xzg^Rusy, Xzg^Edp, Xzg^Rusy, Xzg^Edp, Xzg^Rusy, Xzg^Rusy, Xzg, Xzg, Xzg, Xzg, Xzg, Xzg, Xzgg, Xzgg^Edp, Xzgg^Edp, Xzgg, Xzgg, Xzg, Xzg, Xzg, Xzg^Edp, Xzg^Edp, Xzg, Xzg^Edp, Xzg^Edp, Xzg^Edp, Xzg, Xzg^Edp, Xzg, Xzg^Edp, Xzg, Xzg, Xzg, Xzg, Xzg, Xzg, Xzg, Xzg^Rusy, Xzg^Rusy, Xzg^Rusy, Xzg^Rusy, Xzg^Rusy, Xzg^Rusy, Xzg^Rusy, Xzg, Xzg, Xzg^Edp, Xzg, Xzg, Xzg, Xzg, Xzg^Edp
Xzg, Xzg, Xzg, Xzg^Edp, Xzg, Xzg, Xzg^Edp, Xzg, Xzg, Xzg^Edp, Xzg^Edp, Xzg^Edp, Xzg, Xzg, Xzg, Xzg, Xzg, Xzgg, Xzg, Xzg, Xzg, Xzg, Xzg^Edp, Xzg^Edp, Xzg^Edp, Xzg^Edp, Xzg^Edp, Xzg^Edp, Xzg^Edp, Xzg^Edp, Xzg^Esd, Xzg^Edp, Xzg, Xzg, Xzg, Xzg, Xzg, Xzg, Xzg, Xzg, Xzg, Xzg^Rusy, Xzg^Rusy, Xzg^Rusy, Xzg^Rusy, Xzg^Rusy, Xzg^Rusy, Xzg, Xzg, Xzg^Edp, Xzg, Xzg, Xzg, Xzg^Edp, Xzg
Xzg, Xzg, Xzg, Xzg, Xzg, Xzg, Xzg^Edp, Xzg^Edp, Xzg^Edp, Xzg^Edp, Xzg, Xzg, Xzg, Xzg, Xzg, Xzg, Xzg, Xzgg, Xzg, Xzg^Edp, Xzg, Xzg, Xzg, Xzg^Edp, Xzg^Edp, Xzg^Edp, Xzg^Edp, Xzg^Edp, Xzg, Xzg, Xzg, Xzg^Edp, Xzg^Edp, Xzg, Xzg, Xzg, Xzg^Rusy, Xzg, Xzg^Rusy, Xzg^Rusy, Xzg^Rusy, Xzg^Rusy, Xzg^Rusy, Xzg^Rusy, Xzg^Rusy, Xzg^Rusy, Xzg^Rusy, Xzg, Xzg^Rusy, Xzg, Xzg, Xzgg^Edp, Xzgg^Edp, Xzg^Edp, Xzg
Xzg, Xzg, Xzg, Xzg, Xzg, Xzg, Xzg, Xzg^Edp, Xzg, Xzg^Edp, Xzg, Xzg^Edp, Xzg, Xzg^Edp, Xzg, Xzg, Xzg, Xzg, Xzg, Xzg, Xzg, Xzg, Xzg, Xzg, Xzg, Xzg, Xzg^Edp, Xzg, Xzg^Edp, Xzg^Edp, Xzg, Xzg, Xzg, Xzg, Xzg, Xzg, Xzg, Xzg^Rusy, Xzg, Xzg^Rusy, Xzg^Rusy, Xzg, Xzg, Xzg^Rusy, Xzg, Xzg^Rusy, Xzg, Xzg, Xzg^Rusy, Xzg, Xzg, Xzgg^Edp, Xzg, Xzg, Xzg
Xzg, Xzg, Xzg, Xzg, Xzg, Xzg, Xzg, Xzg, Xzg, Xzg^Edp, Xzg, Xzg^Edp, Xzg, Xzg, Xzg, Xzg, Xzg, Xzg, Xzg, Xzg, Xzg, Xzg, Xzg, Xzg, Xzg, Xzg^Edp, Xzg, Xzg^Edp, Xzg, Xzg, Xzg, Xzg, Xzg, Xzg, Xzg, Xzg, Xzg, Xzg, Xzg, Xzg, Xzg, Xzg, Xzg, Xzg, Xzg, Xzg, Xzg, Xzg, Xzg, Xzg, Xzg, Xzg, Xzg, Xzg, Xzg
Xzg, Xzg, Xzg, Xzg, Xzg, Xzg, Xzg, Xzg, Xzg, Xzg, Xzg, Xzg, Xzg, Xzg, Xzg, Xzg, Xzg, Xzg, Xzg, Xzg, Xzg, Xzg, Xzg, Xzg, Xzg, Xzg, Xzg, Xzg, Xzg, Xzg, Xzg, Xzg, Xzg, Xzg, Xzg, Xzg, Xzg, Xzg, Xzg, Xzg, Xzg, Xzg, Xzg, Xzg, Xzg, Xzg, Xzg, Xzg, Xzg, Xzg, Xzg, Xzg, Xzg, Xzg, Xzg
