Xu, Xu, Xu, Xu, Xu, Xu, Xu, Xu, Xu, Xu, Xu, Xu, Xu, Xu, Xu, Xu, Xu, Xu, Xu, Xu, Xu, Xu, Xu, Xu, Xu, Xu, Xu, Xu, Xu, Uu, Uu, Uu, Xu, Xu, Xu, Xu, Xu, Xu, Xu, Xu, Xu, Xu, Xu, Xu, Xu, Xu, Xu, Xu, Xu, Xu, Xu, Xu, Xu, Xu, Xu, Xu, Xu, Xu, Xu, Xu, Xu, Xu, Xu, Xu, Xu, Xu, Xu, Xu, Xu, Xu, Xu, Xu, Xu, Xu, Xu, Xu, Xu, Xu, Xu, Xu, Xu, Xu, Xu, Xu, Xu, Xu, Xu, Xu, Xu, Xu, Xu, Xu, Xu, Xu, Xu, Xu, Xu, Xu, Xu
Xu, Xu, Xu, Xu, Xu, Xu, Xu, Xu, Xu, Xu, Xu, Xu, Xu, Xu, Xu, Xu, Xu, Xu, Xu, Xu, Xu, Xu, Xu, Xu, Xu, Xu, Xu, Xu, Rb, Rb, Xu, Xu, Xu, Xu, Xu, Xu, Xu, Xu, Xu, Xu, Xu, Xu, Xu, Xu, Xu, Xu, Xu, Xu, Xu, Xu, Xu, Xu, Xu, Xu, Xu, Xu, Xu, Xu, Xu, Xu, Xu, Xu, Xu, Xu, Xu, Xu, Xu, Xu, Xu, Xu, Xu, Xu, Xu, Xu, Xu, Xu, Xu, Xu, Xu, Xu, Xu, Xu, Xu, Xu, Xu, Xu, Xu, Xu, Xu, Xu, Xu, Xu, Xu, Xu, Xu, Xu, Xu, Xu, Xu
Xu, Xu, Xu, Xu, Xu, Xu, Xu, Xu, Xu, Xu, Xu, Xu, Xu, Xu, Xu, Xu, Xu, Xu, Xu, Xu, Xu, Xu, Xu, Xu, Xu, Xu, Xu, Uu, Xu, Uh, Xu, Xu, Xu, Xu, Xu, Xu, Xu, Xu, Xu, Xu, Xu, Xu, Xu, Xu, Xu, Xu, Xu, Xu, Xu, Xu, Xu, Xu, Xu, Xu, Xu, Xu, Xu, Xu, Xu, Xu, Xu, Xu, Xu, Xu, Xu, Xu, Xu, Xu, Xu, Xu, Xu, Xu, Xu, Xu, Xu, Xu, Xu, Xu, Xu, Xu, Xu, Xu, Xu, Xu, Xu, Xu, Xu, Xu, Xu, Xu, Xu, Xu, Xu, Xu, Xu, Xu, Xu, Xu, Xu
Xu, Xu, Xu, Xu, Xu, Xu, Xu, Xu, Xu, Xu, Xu, Xu, Xu, Xu, Xu, Xu, Xu, Xu, Xu, Xu, Xu, Xu, Xu, Xu, Uu^Dr, Rb^Dr, Rb, Uu, Uu^Emf, Uh^Uf, Xu, Xu, Xu, Xu, Xu, Xu, Xu, Xu, Xu, Xu, Xu, Xu, Xu, Xu, Xu, Xu, Xu, Xu, Xu, Xu, Xu, Xu, Xu, Xu, Xu, Xu, Xu, Xu, Xu, Xu, Xu, Xu, Xu, Xu, Xu, Xu, Xu, Xu, Xu, Xu, Xu, Xu, Xu, Xu, Xu, Xu, Xu, Xu, Xu, Xu, Xu, Xu, Xu, Xu, Xu, Xu, Xu, Xu, Xu, Xu, Xu, Xu, Xu, Xu, Xu, Xu, Xu, Xu, Xu
Xu, Xu, Xu, Xu, Xu, Xu, Xu, Xu, Xu, Xu, Xu, Xu, Xu, Xu, Xu, Xu, Xu, Xu, Xu, Xu, Xu, Xu, Xu, Xu, Rb, Xu, Xos, Xu, Xu, Xu, Xu, Xu, Uu^Edb, Xu, Xos, Xu, Xu, Xu, Xu, Xu, Xu, Xu, Xu, Xu, Xu, Xu, Xu, Xu, Xu, Xu, Xu, Xu, Xu, Xu, Xu, Xu, Xu, Xu, Xu, Xu, Xu, Xu, Xu, Xu, Xu, Xu, Xu, Xu, Xu, Xu, Xu, Xu, Xu, Xu, Xu, Xu, Xu, Xu, Xu, Xu, Xu, Xu, Xu, Xu, Xu, Xu, Xu, Xu, Xu, Xu, Xu, Xu, Xu, Xu, Xu, Xu, Xu, Xu, Xu
Xu, Xu, Xu, Xu, Xu, Xu, Xu, Xu, Xu, Xu, Xu, Xu, Xu, Xu, Xu, Xu, Xu, Xu, Xu, Xu, Xos, Xu, Rb^Edb, Rb^Em, Rr^Edb, Rr^Edb, Rr, Xos, Xos, Xos, Xu, Rb, Rb^Edb, Rr^Edb, Rr^Edb, Xos, Xu, Xu, Xu, Xu, Xu, Xu, Xu, Xu, Xu, Xu, Xu, Xu, Xu, Xu, Xu, Xu, Xu, Xu, Xu, Xu, Xu, Xu, Xu, Xu, Xu, Xu, Xu, Xu, Xu, Xu, Xu, Xu, Xu, Xu, Xu, Xu, Xu, Xu, Xu, Xu, Xu, Xu, Xu, Xu, Xu, Xu, Xu, Xu, Xu, Xu, Xu, Xu, Xu, Xu, Xu, Xu, Xu, Xu, Xu, Xu, Xu, Xu, Xu
Xu, Xu, Xu, Xu, Xu, Xu, Xu, Xu, Xu, Xu, Xu, Xu, Xu, Xu, Xu, Xu, Xu, Xos, Xos, Xos, Rr, Rr^Edb, Rb^Edb, Rb^Edb, Rr, Rr^Edb, Xu, Rr^Pr/, Uu^Emf, Rb, Uu, Rr^Pr\, Rr^Pr\, Rb^Edb, Rr, Rr, Xos, Xu, Xos, Xu, Xu, Xu, Xu, Xu, Xu, Xu, Xu, Xu, Xu, Xu, Xu, Xu, Xu, Xu, Xu, Xu, Xu, Xu, Xu, Xu, Xu, Xu, Xu, Xu, Xu, Xu, Xu, Xu, Xu, Xu, Xu, Xu, Xu, Xu, Xu, Xu, Xu, Xu, Xu, Xu, Xu, Xu, Xu, Xu, Xu, Xu, Xu, Xu, Xu, Xu, Xu, Xu, Xu, Xu, Xu, Xu, Xu, Xu, Xu
Xu, Xu, Xu, Xu, Xu, Xu, Xu, Xu, Xu, Xu, Xu, Xu, Xu, Xu, Xu, Xu, Xos, Xos, Rr^Edb, Xos, Xos, Rr^Edb, Rr^Edb, Rb^Edb, Rr^Pr/, Rr^Pr/, Rb^Es, Uu, Uu^Em, Uu^Em, Xu, Uu, Rb, Rr^Pr\, Xu, Xos, Rr, Rr, Rr, Xos, Xos, Xu, Xu, Xu, Xu, Xu, Xu, Xu, Xu, Xu, Xu, Xu, Xu, Xu, Xu, Xu, Xu, Xu, Xu, Xu, Xu, Xu, Xu, Xu, Xu, Xu, Xu, Xu, Xu, Xu, Xu, Xu, Xu, Xu, Xu, Xu, Xu, Xu, Xu, Xu, Xu, Xu, Xu, Xu, Xu, Xu, Xu, Xu, Xu, Xu, Xu, Xu, Xu, Xu, Xu, Xu, Xu, Xu, Xu
Xu, Xu, Xu, Xu, Xu, Xu, Xu, Xu, Xu, Xu, Xu, Xu, Xu, Xu, Xu, Xu, Rr^Edb, Rr^Edb, Rr^Edb, Rr^Edb, Rr, Xos, Xos, Xu, Uu, Rb, Rb, Rb, Xu, Rb, Rb^Es, Uu, Xu, Uu, Rb, Rr^Pr\, Rr^Pr\, Rr^Edb, Rb^Edb, Rr^Edb, Rr, Xu, Xu, Xu, Xu, Xu, Xu, Xu, Xu, Xu, Xu, Xu, Xu, Xu, Xu, Xu, Xu, Xu, Xu, Xu, Xu, Xu, Xu, Xu, Xu, Xu, Xu, Xu, Xu, Xu, Xu, Xu, Xu, Xu, Xu, Xu, Xu, Xu, Xu, Xu, Xu, Xu, Xu, Xu, Xu, Xu, Xu, Xu, Xu, Xu, Xu, Xu, Xu, Xu, Xu, Xu, Xu, Xu, Xu
Xu, Xu, Xu, Xu, Xu, Xu, Xu, Xu, Xu, Xu, Xu, Xu, Xos, Xos, Rr, Rb^Edb, Rb^Edb, Rr^Edb, Rb^Edb, Rr^Edb, Rr^Pr/, Xu, Rb, Uu, Uu, Rb, Rr^Pr/, Rr^Pr/, Rb^Edb, Rr^Pr\, Rr^Pr\, Uu, Uu, Uu^Emf, Xu, Rb, Rb, Rr^Pr\, Xu, Uu^Edb, Xu, Xu, Xu, Xu, Xu, Xu, Xu, Xu, Xu, Xu, Xu, Xu, Xu, Xu, Xu, Xu, Xu, Xu, Xu, Xu, Xu, Xu, Xu, Xu, Xu, Xu, Xu, Xu, Xu, Xu, Xu, Xu, Xu, Xu, Xu, Xu, Xu, Xu, Xu, Xu, Xu, Xu, Xu, Xu, Xu, Xu, Xu, Xu, Xu, Xu, Xu, Xu, Xu, Xu, Xu, Xu, Xu, Xu, Xu
Xu, Xu, Xu, Xu, Xu, Xu, Xu, Xu, Xu, Xu, Xu, Xos, Rr, Rr, Rb^Em, Rb^Edb, Rr^Edb, Rb^Edb, Xu, Rr^Pr/, Rb, Rb, Uu, Uu, Xu, Rr^Pr/, Rr^Edb, Rb^Edb, Rr^Edb, Rb^Edb, Rr, Rr^Pr\, Xos, Uu^Em, Uu, Rb^Es, Rb, Uu^Em, Rr^Pr/, Xu, Xos, Xu, Xu, Xu, Xu, Xu, Xu, Xu, Xu, Xu, Xu, Xu, Xu, Xu, Xu, Xu, Xu, Xu, Xu, Xu, Xu, Xu, Xu, Xu, Xu, Xu, Xu, Xu, Xu, Xu, Xu, Xu, Xu, Xu, Xu, Xu, Xu, Xu, Xu, Xu, Xu, Xu, Xu, Xu, Xu, Xu, Xu, Xu, Xu, Xu, Xu, Xu, Xu, Xu, Xu, Xu, Xu, Xu, Xu
Xu, Xu, Xu, Xu, Xu, Xu, Xu, Xu, Xos, Xu, Xu, Rr, Rb, Rb, Rb, Rr, Rr^Pr/, Rr^Pr/, Rb^Es, Rb, Rb^Em, Uu^Emf, Xu, Xu, Uu^Emf, Rr, Rb^Edb, Rr^Edb, Rr^Edb, Rr^Edb, Rr^Pr/, Rr^Pr/, Uu^Emf, Uu, Rb, Rb, Rr^Pr/, Rr^Pr/, Uu^Em, Uu^Emf, Rr, Xos, Xos, Xu, Xu, Xu, Xu, Xu, Xu, Xu, Xu, Xu, Xu, Xu, Xu, Xu, Xu, Xu, Xu, Xu, Xu, Xu, Xu, Xu, Xu, Xu, Xu, Xu, Xu, Xu, Xu, Xu, Xu, Xu, Xu, Xu, Xu, Xu, Xu, Xu, Xu, Xu, Xu, Xu, Xu, Xu, Xu, Xu, Xu, Xu, Xu, Xu, Xu, Xu, Xu, Xu, Xu, Xu, Xu
Xu, Xu, Xu, Xu, Xu, Xu, Xos, Xos, Rr^Edb, Rr, Uu^Em, Xu, Xu, Uu, Xu, Rr^Pr/, Rb, Rb, Rb, Rb, Rb^Em, Rb, Rr^Pr/, Xu, Xu, Uu^Em, Uu, Rb^Edb, Rb^Edb, Xu, Xu, Uu, Uu, Rb, Rb, Xu, Rr^Pr\, Rr, Rb, Rr, Rr^Edb, Rr, Xos, Xu, Xu, Xu, Xu, Xu, Xu, Xu, Xu, Xu, Xu, Xu, Xu, Xu, Xu, Xu, Xu, Xu, Xu, Xu, Xu, Xu, Xu, Xu, Xu, Xu, Xu, Xu, Xu, Xu, Xu, Xu, Xu, Xu, Xu, Xu, Xu, Xu, Xu, Xu, Xu, Xu, Xu, Xu, Xu, Xu, Xu, Xu, Xu, Xu, Xu, Xu, Xu, Xu, Xu, Xu, Xu
Xu, Xu, Xu, Xu, Xu, Xos, Rr^Edb, Rr^Edb, Rr^Edb, Rb^Edb, Rr, Uu, Xu, Xu, Uu, Uu, Rb, Rb, Xu, Rb, Xu, Rr^Pr/, Rr^Edb, Uu^Edb, Rb^Edb, Xu, Xos, Rb, Rr^Edb, Rb, Rb, Xu, Xos, Rb^Es, Rb, Rb, Uu, Xu, Xu, Rb^Edb, Xu, Xos, Xu, Xu, Xu, Xu, Xu, Xu, Xu, Xu, Xu, Xu, Xu, Xu, Xu, Xu, Xu, Xu, Xu, Xu, Xu, Xu, Xu, Xu, Xu, Xu, Xu, Xu, Xu, Xu, Xu, Xu, Xu, Xu, Xu, Xu, Xu, Xu, Xu, Xu, Xu, Xu, Xu, Xu, Xu, Xu, Xu, Xu, Xu, Xu, Xu, Xu, Xu, Xu, Xu, Xu, Xu, Xu, Xu
Xu, Xu, Xu, Xu, Xu, Rr, Rr^Edb, Rb^Edb, Rb^Edb, Rr^Edb, Rr^Pr/, Rr^Pr/, Rb, Rb, Rb, Rb, Xos, Rr^Pr/, Rb, Xu, Xos, Rr, Rr^Edb, Rr^Edb, Rr^Edb, Rb^Edb, Uu, Xos, Xos, Rr, Rr^Pr/, Rr^Pr/, Rb, Rb, Rb, Rb^Em, Uu, Xu, Uu, Xu, Xos, Xu, Xu, Xu, Xu, Xu, Xu, Xu, Xu, Xu, Xu, Xu, Xu, Xu, Xu, Xu, Xu, Xu, Xu, Xu, Xu, Xu, Xu, Xu, Xu, Xu, Xu, Xu, Xu, Xu, Xu, Xu, Xu, Xu, Xu, Xu, Xu, Xu, Xu, Xu, Xu, Xu, Xu, Xu, Xu, Xu, Xu, Xu, Xu, Xu, Xu, Xu, Xu, Xu, Xu, Xu, Xu, Xu, Xu
Xu, Xu, Xu, Xu, Xu, Xos, Xos, Rb^Edb, Rr^Pr/, Xos, Rb, Rb, Uu, Uu^Emf, Rr^Pr/, Rr^Pr/, Rr^Edb, Rb^Edb, Rr^Edb, Rb, Rr^Edb, Xos, Xos, Rr^Edb, Rb^Edb, Rr^Edb, Rr^Pr/, Xu, Uu^Emf, Xu, Rb^Es, Rb, Rb, Rb, Xu, Uu, Rb, Uu^Em, Rb, Xu, Rb^Es, Xos, Xos, Xos, Xu, Xu, Xu, Xos, Xu, Xu, Xu, Xu, Xu, Xu, Xu, Xu, Xu, Xu, Xu, Xu, Xu, Xu, Xu, Xu, Xu, Xu, Xu, Xu, Xu, Xu, Xu, Xu, Xu, Xu, Xu, Xu, Xu, Xu, Xu, Xu, Xu, Xu, Xu, Xu, Xu, Xu, Xu, Xu, Xu, Xu, Xu, Xu, Xu, Xu, Xu, Xu, Xu, Xu, Xu
Xu, Xos, Xu, Xu, Xu, Xu, Xu, Xu, Rb^Es, Rb, Rb, Rb^Es, Xu, Xu, Rb, Rb, Rb^Edb, Rr^Edb, Rr^Edb, Rr, Rr^Edb, Rr, Rb, Xu, Xu, Rr^Pr/, Uu, Uu^Emf, Rb, Rb^Es, Rb, Rb, Rr^Pr/, Rr^Pr/, Rb^Edb, Xos, Rr^Pr\, Rb, Rb^Es, Rb^Em, Rb, Xu, Rb^Es, Xos, Xu, Xu, Rr, Rb, Rr^Edb, Xos, Xu, Xu, Xu, Xu, Xu, Xu, Xu, Xu, Xu, Xu, Xu, Xu, Xu, Xu, Xu, Xu, Xu, Xu, Xu, Xu, Xu, Xu, Xu, Xu, Xu, Xu, Xu, Xu, Xu, Xu, Xu, Xu, Xu, Xu, Xu, Xu, Xu, Xu, Xu, Xu, Xu, Xu, Xu, Xu, Xu, Xu, Xu, Xu, Xu
Xu, Xu, Xu, Xu, Xos, Xu, Xu, Rb, Rb, Uu, Xu, Rb, Uu^Em, Xu, Rr^Pr\, Rb, Rr, Rr^Edb, Rr^Pr/, Xu, Rr^Pr\, Rr^Edb, Rb, Rb, Rr^Pr/, Xu, Uu, Uu, Rb, Rb, Xos, Xu, Rb^Em, Rr^Edb, Rr^Edb, Rr^Edb, Rb, Rr^Pr\, Xos, Rb, Rb, Rb, Uu, Xu, Xu, Uu, Rr, Rb^Edb, Rb^Edb, Rr^Edb, Rr^Edb, Xos, Xu, Xu, Xu, Xu, Xu, Xu, Xu, Xu, Xu, Xu, Xu, Xu, Xu, Xu, Xu, Xu, Xu, Xu, Xu, Xu, Xu, Xu, Xu, Xu, Xu, Xu, Xu, Xu, Xu, Xu, Xu, Xu, Xu, Xu, Xu, Xu, Xu, Xu, Xu, Xu, Xu, Xu, Xu, Xu, Xu, Xu, Xu
Xu, Xu, Xu, Xu, Rr, Rb, Rb^Edb, Rr^Pr\, Rr^Pr\, Uu^Em, Uu, Uu, Xu, Uu^Emf, Uu^Emf, Xos, Xu, Xu, Rb, Rb, Rb, Rr^Pr\, Xu, Rr^Pr/, Rb, Rb, Uu, Rb, Rr^Pr/, Xu, Rr^Edb, Rb^Edb, Rr^Edb, Rr^Edb, Rr^Edb, Rr^Edb, Rr, Rb, Rr^Pr/, Xos, Uu, Uu, Uu, Uu, Uu, Rr^Pr\, Rr^Pr\, Rb^Edb, Rr^Edb, Rb^Edb, Rr^Edb, Rb^Edb, Rb, Xos, Xu, Xu, Xu, Xu, Xu, Xu, Xu, Xu, Xu, Xu, Xu, Xu, Xu, Xu, Xu, Xu, Xu, Xu, Xu, Xu, Xu, Xu, Xu, Xu, Xu, Xu, Xu, Xu, Xu, Xu, Xu, Xu, Xu, Xu, Xu, Xu, Xu, Xu, Xu, Xu, Xu, Xu, Xu, Xu, Xu
Xu, Xu, Xu, Xu, Xos, Rr^Edb, Rr, Rr^Edb, Rr, Rr^Pr\, Xu, Rb^Em, Rb, Uu, Xu, Uu, Uu, Uu^Em, Rb, Rb, Rb, Rb^Es, Rb, Rb, Rb, Uu, Xos, Xu, Rb, Rb^Em, Rr^Edb, Rr^Edb, Rb^Edb, Rr, Rr^Pr/, Xos, Xos, Rr^Pr/, Rb, Uu, Rr^Pr/, Xu, Xu, Rb, Rb, Uu, Rb, Rr^Pr\, Xu, Rr^Edb, Rb^Edb, Rb^Edb, Xos, Xos, Xu, Xu, Xu, Xu, Xu, Xu, Xu, Xu, Xu, Xu, Xu, Xu, Xu, Xu, Xu, Xu, Xu, Xu, Xu, Xu, Xu, Xu, Xu, Xu, Xu, Xu, Xu, Xu, Xu, Xu, Xu, Xu, Xu, Xu, Xu, Xu, Xu, Xu, Xu, Xu, Xu, Xu, Xu, Xu, Xu
Xu, Xu, Xu, Xu, Xu, Xu, Xu, Rr^Edb, Xu, Xu, Rr^Edb, Rr^Pr\, Rr^Pr\, Uu, Rb, Rb, Rb^Es, Rb, Xos, Xu, Rr^Pr\, Rb, Rb, Rb, Rb, Uu, Uu, Xu, Rr^Pr\, Rr, Rr, Rr^Edb, Rb, Xos, Xos, Rb, Rb, Rb, Rb^Es, Xu, Rr^Pr\, Rb, Rr^Edb, Rr^Pr\, Rr^Pr\, Rb, Rb, Rb, Rb, Rr^Pr\, Xu, Xu, Xu, Xu, Xu, Xu, Xu, Xu, Xu, Xu, Xu, Xu, Xu, Xu, Xu, Xu, Xu, Xu, Xu, Xu, Xu, Xu, Xu, Xu, Xu, Xu, Xu, Xu, Xu, Xu, Xu, Xu, Xu, Xu, Xu, Xu, Xu, Xu, Xu, Xu, Xu, Xu, Xu, Xu, Xu, Xu, Xu, Xu, Xu
Xu, Xu, Xu, Xu, Xu, Xu, Xu, Xu, Xu, Rr, Rr^Edb, Rr^Edb, Rb, Xu, Xu, Rb, Rr^Pr/, Rr^Pr/, Rr^Edb, Rb, Rr^Edb, Rr^Pr\, Xu, Xu, Uu^Emf, Uu^Emf, Uu^Em, Rb, Rb, Rr^Pr\, Rr^Pr\, Rr, Rr^Pr/, Xu, Rb, Rb, Uu^Em, Rb, Rb, Uu^Em, Uu^Em, Xu, Rr^Pr\, Rr, Xu, Xu, Rb, Rb, Rb^Es, Rb, Xu, Xos, Xu, Xos, Xos, Xu, Xu, Xu, Xu, Xu, Xu, Xu, Xu, Xu, Xu, Xu, Xu, Xu, Xu, Xu, Xu, Xu, Xu, Xu, Xu, Xu, Xu, Xu, Xu, Xu, Xu, Xu, Xu, Xu, Xu, Xu, Xu, Xu, Xu, Xu, Xu, Xu, Xu, Xu, Xu, Xu, Xu, Xu, Xu
Xu, Xu, Xu, Xu, Xu, Xu, Xu, Xu, Xu, Xos, Xu, Rr^Edb, Rr^Edb, Rb, Xos, Xu, Xu, Rr, Rr^Edb, Rr^Edb, Rr^Edb, Rr, Xos, Xos, Xos, Xu, Uu, Rb, Rb^Es, Rb, Rb, Xu, Uu^Emf, Uu, Xu, Xu, Rr^Pr\, Rb, Rb, Rb, Rb, Rb, Uu, Xu, Uu, Uu, Uu^Em, Rb, Rb, Rb, Rb, Rb^Es, Rb, Rb^Emf, Rb^Emf, Xos, Xu, Xu, Xu, Xu, Xu, Xu, Xos, Xu, Xu, Xu, Xu, Xu, Xu, Xu, Xu, Xu, Xu, Xu, Xu, Xu, Xu, Xu, Xu, Xu, Xu, Xu, Xu, Xu, Xu, Xu, Xu, Xu, Xu, Xu, Xu, Xu, Xu, Xu, Xu, Xu, Xu, Xu, Xu
Xu, Xu, Xu, Xu, Xu, Xu, Xu, Xu, Xu, Xu, Xu, Xu, Xu, Xu, Xu, Xu, Xu, Xos, Xos, Rr, Xos, Xos, Xu, Xu, Xu, Xu, Xu, Xu, Rb, Rb, Rb^Es, Rb^Es, Uu, Xu, Xu, Rb, Rr^Edb, Rr^Pr\, Xu, Rb, Rb^Es, Rb, Rb^Es, Uu^Em, Rb, Rb, Rb^Es, Rb, Uu, Qxua, Rb, Rb, Uu, Rb, Rb^Es, Rb, Xos, Xu, Xu, Xu, Xos, Xu, Rb^Emf, Xos, Xos, Xu, Xu, Xu, Xu, Xu, Xu, Xu, Xu, Xu, Xu, Xu, Xu, Xu, Xu, Xu, Xu, Xu, Xu, Xu, Xu, Xu, Xu, Xu, Xu, Xu, Xu, Xu, Xu, Xu, Xu, Xu, Xu, Xu, Xu
Xu, Xu, Xu, Xu, Xu, Xu, Xu, Xu, Xu, Xu, Xu, Xu, Xu, Xu, Xu, Xu, Xu, Xu, Xu, Xu, Xu, Xu, Xu, Xu, Xu, Xu, Xu, Xu, Xu, Xu, Xu, Rb, Rb^Es, Rb, Uu^Emf, Xu, Rr^Pr\, Rb^Edb, Rr^Pr/, Xu, Rb^Es, Rb, Rb, Rb, Rb, Uu, Qxua, Qxua, Cdr, Uu^Em, Uu^Emf, Qxua, Uu, Uu^Emf, Rb, Rb, Xu, Xu, Xu, Xu, Rr, Rb, Rr, Rr, Rb^Edb, Xu, Xu, Xu, Xu, Xu, Xu, Xu, Xu, Xu, Xu, Xu, Xu, Xu, Xu, Xu, Xu, Xu, Xu, Xu, Xu, Xu, Xu, Xu, Xu, Xu, Xu, Xu, Xu, Xu, Xu, Xu, Xu, Xu, Xu
Xu, Xu, Xu, Xu, Xu, Xu, Xu, Xu, Xu, Xu, Xu, Xu, Xu, Xu, Xu, Xu, Xu, Xu, Xu, Xu, Xu, Xu, Xu, Xu, Xu, Xu, Xos, Xu, Rb^Edb, Rb, Rb, Rr^Pr\, Rr^Pr\, Rb, Rb, Uu, Uu, Xu, Uu, Rb, Uu, Rb^Es, Rb, Rb, Qxua, Uu, Qxua, Cdr, Kdr, Cdr, Qxua, Uu^Emf, Qxua, Uu, Rb, Rb, Rb, Rb^Es, Rb, Rr^Pr\, Rr^Pr\, Rb, Rb, Rr^Edb, Rr^Edb, Rb^Edb, Rb^Edb, Xu, Xos, Xu, Xu, Xu, Xu, Xu, Xu, Xu, Xu, Xu, Xu, Xu, Xu, Xu, Xu, Xu, Xu, Xu, Xu, Xu, Xu, Xu, Xu, Xu, Xu, Xu, Xu, Xu, Xu, Xu, Xu
Xu, Xu, Xu, Xu, Xu, Xu, Xu, Xu, Xu, Xu, Xu, Xu, Xu, Xu, Xu, Xu, Xu, Xu, Xu, Xu, Xu, Xu, Xu, Xu, Xu, Xu, Xu, Rr, Rb, Rr^Edb, Rr^Edb, Rr, Rr, Xu, Rr^Pr\, Uu, Uu^Em, Uu, Uu^Em, Rb, Uu^Em, Rb^Es, Rb^Es, Rb, Uu, Uu^Edb, Uu, 2 Cdr, Cdr, Cdr, Qxua, Rb, Uu, Rb, Uu, Rb, Rb, Rb, Rb, Rb, Rb^Em, Xu, Rr^Pr\, Rr^Edb, Rr^Edb, Rb^Edb, Rb^Edb, Rb, Xos, Xu, Xu, Xu, Xu, Xu, Xu, Xu, Xu, Xu, Xu, Xu, Xu, Xu, Xu, Xu, Xu, Xu, Xu, Xu, Xu, Xu, Xu, Xu, Xu, Xu, Xu, Xu, Xu, Xu, Xu
Xu, Xu, Xu, Xu, Xu, Xu, Xu, Xu, Xu, Xu, Xu, Xu, Xu, Xu, Xu, Xu, Xu, Xu, Xu, Xu, Xu, Xu, Xu, Xu, Xu, Xu, Xu, Xu, Xos, Rb^Edb, Rb^Edb, Rr^Edb, Rr, Rr, Rr, Rr^Pr\, Xu, Uu^Em, Xu, Uu^Em, Uu^Em, Rb, Rb^Es, Rb, Rb, Qxua, Rb, Rb^Edb, Rb, Qxua, Rb, Rb, Rb, Rb^Em, Uu^Em, Uu^Emf, Rr^Pr/, Xu, Rr^Pr\, Rb, Rb, Rb, Rb, Rr^Pr\, Xu, Rr^Edb, Xu, Xu, Xu, Xu, Xu, Xu, Xu, Xu, Xu, Xu, Xu, Xu, Xu, Xu, Xu, Xu, Xu, Xu, Xu, Xu, Xu, Xu, Xu, Xu, Xu, Xu, Xu, Xu, Xu, Xu, Xu, Xu, Xu
Xu, Xu, Xu, Xu, Xu, Xu, Xu, Xu, Xu, Xu, Xu, Xu, Xu, Xu, Xu, Xu, Xu, Xu, Xu, Xu, Xu, Xu, Xu, Xu, Xu, Xu, Xu, Xos, Xos, Rb^Edb, Rb^Edb, Rr^Edb, Uu^Em, Uu^Emf, Xos, Xos, Xu, Xu, Uu, Uu, Rb, Rb, Rb, Rb, Rb^Es, Rb, Rb, Qxua, Uu, Rb, Uu, Rb, Rb, Uu, Uu^Emf, Xu, Xu, Uu, Rr^Edb, Xu, Xu, Rb, Uu^Em, Rb, Rb, Xu, Uu^Emf, Xu, Xu, Xu, Xu, Xu, Xu, Xu, Xos, Xu, Xos, Xu, Xu, Xu, Xu, Xu, Xu, Xu, Xu, Xu, Xu, Xu, Xu, Xu, Xu, Xu, Xu, Xu, Xu, Xu, Xu, Xu, Xu
Xu, Xu, Xu, Xu, Xu, Xu, Xu, Xu, Xu, Xu, Xu, Xu, Xu, Xu, Xu, Xu, Xu, Xu, Xu, Xu, Xu, Xu, Xu, Xu, Xu, Xu, Xu, Xos, Rr, Rb^Edb, Rb^Edb, Rb^Edb, Uu, Xu, Xos, Xos, Xos, Xu, Rb, Rb, Uu, Rb, Rb, Rb, Rb, Rb, Rb, Rb, Rb, Uu^Em, Uu, Rb, Rb, Uu^Em, Uu, Uu, Rb, Rr^Pr\, Rr^Pr\, Rb^Edb, Xu, Xu, Uu^Emf, Uu, Rb, Uu^Em, Uu, Xu, Uu, Xu, Xos, Xu, Xos, Xos, Rr, Uu, Uu, Xos, Xu, Xu, Xos, Xu, 3 Rr, Xu, Xu, Xu, Xu, Xu, Xu, Xu, Xu, Xu, Xu, Xu, Xu, Xu, Xu, Xu, Xu
Xu, Xu, Xu, Xu, Xu, Xu, Xu, Xu, Xu, Xu, Xu, Xu, Xu, Xu, Xu, Xu, Xu, Xu, Xu, Xu, Xu, Xu, Xu, Xu, Xos, Xu, Rb, Rb, Rr, Rr^Edb, Rr^Edb, Rb^Edb, Rr^Pr/, Rr^Pr/, Rb, Xos, Rb, Rb, Rb, Uu, Rb, Rb, Rb, Rb, Xu, Rb, Rb, Rb, Uu^Em, Uu^Emf, Xu, Xu, Rr^Pr\, Rb, Rb, Rb, Rb, Rb^Es, Uu, Xu, Uu^Em, Uu, Rr^Pr/, Xu, Rr^Pr\, Rb^Es, Rb, Uu^Em, Uu, Xu, Rb, Xos, Xu, Rr, Rb, Rb^Em, Rb^Em, Rr, Xu, Xu, Xu, Rr, Rb, Rb^Em, Uu^Em, Xos, Xu, Xu, Xu, Xu, Xu, Xu, Xu, Xu, Xu, Xu, Xu, Xu, Xu
Xu, Xu, Xu, Xu, Xu, Xu, Xu, Xu, Xu, Xu, Xu, Xu, Xu, Xu, Xu, Xu, Xu, Xu, Xu, Xu, Xu, Xu, Xos, Xu, Xos, Xu, Xu, Rb, Rb, Rr, Rr^Pr/, Xu, Rb, Rb, Rb, Rb, Rb, Rb, Uu, Rb, Xu, Xos, Xos, Xos, Xu, Rb, Rb, Rb, Rb, Xu, Rr^Pr\, Rb, Rb^Edb, Xu, Rr^Pr\, Rb, Rb, Rb, Rb, Uu, Xos, Xu, Uu, Rr, Rr^Edb, Rr^Pr\, Xu, Rb^Emf, Uu^Em, Rb, Rb^Es, Xu, Uu^Emf, Rr^Pr\, Rr^Pr\, Rb, Xos, Rr^Pr/, Uu^Es, Uu^Es, Uu, Xu, Rr^Pr\, Rr^Edb, Rr, Rr, Xu, Xu, Xu, Xu, Xu, Xu, Xu, Xu, Xu, Xu, Xu, Xu, Xu
Xu, Xu, Xu, Xu, Xu, Xu, Xu, Xu, Xu, Xu, Xu, Xu, Xu, Xu, Xu, Xu, Xu, Xu, Xu, Xu, Xos, Xos, Rr^Edb, Rb, Rr, Xos, Xu, Xu, Xu, Xu, Uu, Uu, Rb, Uu, Rb^Es, Rb^Es, Rb, Uu, Uu, Xu, Xu, Xu, Xos, Xos, Rr^Edb, Rr^Pr\, Xu, Rb, Rb, Rb, Rb, Rr^Pr\, Xu, Rr, Rr^Pr/, Xu, Rb, Rb, Xos, Rb, Rr^Pr/, Xos, Rb^Edb, Rr^Edb, Rb^Edb, Rr, Rb, Xu, Xos, Uu, Rb, Rb^Em, Uu^Em, Uu, Uu^Em, Xu, Uu, Rb, Rb^Es, Rb^Es, Xu, Uu, Rb, Rr^Pr\, Xu, Xu, Rr, Rr, Uu^Edb, Xu, Xos, Xu, Xu, Xu, Xu, Xu, Xu, Xu, Xu
Xu, Xu, Xu, Xu, Xu, Xu, Xu, Xu, Xu, Xu, Xu, Xu, Xu, Xu, Xu, Xu, Xu, Xu, Xu, Xu, Rb, Rb^Edb, Rb^Edb, Rb^Edb, Rb, Rr, Rr^Pr/, Xu, Xu, Uu, Uu, Uu, Rb, Rb, Rb^Es, Rb, Rb, Rb, Rr^Pr/, Rr^Pr/, Rr, Uu, Rr, Rr, Rb^Edb, Rb^Edb, Rr, Rr^Pr\, Rr^Pr\, Rb, Rb, Uu, Uu, Xu, Rb, Rb, Rr^Pr/, Rr^Pr/, Rr, Xos, Rr^Edb, Rr^Edb, Rr^Edb, Rb^Edb, Rr, Rb^Edb, Rr^Pr/, Xu, Uu, Uu, Rb, Rb^Es, Xu, Uu, Rb, Uu^Em, Rb^Es, Rb, Xu, Rb, Rb, Uu, Xu, Rb, Rb, Rr^Pr\, Rr^Pr\, Rb^Edb, Rb^Edb, Rr, Rr, Xu, Xu, Xu, Xu, Xu, Xu, Xu, Xu
Xu, Xu, Xu, Xu, Xu, Xu, Xu, Xu, Xu, Xu, Xu, Xu, Xu, Xu, Xu, Xu, Xos, Xu, Xu, Rr, Uu, Rr^Edb, Rr^Edb, Rr^Edb, Xu, Rr^Pr/, Rb, Uu, Rb, Uu, Uu, Rb, Rb, Rb^Es, Rb, Rb^Es, Rr^Pr/, Xu, Rr^Edb, Rr^Edb, Rb^Edb, Uu^Emf, Uu^Emf, Uu^Em, Uu^Em, Rb^Edb, Rb^Edb, Rr^Edb, Rr^Edb, Rr^Pr\, Xu, Rb, Uu, Rb^Es, Rb, Xos, Xos, Rr, Rr, Rr^Edb, Rr^Edb, Rr^Edb, Rb^Edb, Rb, Xos, Rr^Pr/, Rb^Es, Rb, Rb, Rb, Rr^Pr/, Rr^Pr/, Rr, Rr^Pr\, Rr^Pr\, Rb^Es, Rr^Pr/, Xu, Rr, Xos, Rr^Pr\, Uu, Uu^Em, Uu, Xu, Rb, Uu^Em, Xu, Rr^Pr\, Rr^Edb, Xos, Xu, Xu, Xu, Xu, Xu, Xu, Xu, Xu
Xu, Xu, Xu, Xu, Xu, Xu, Xu, Xu, Xu, Xu, Xu, Xu, Xu, Xu, Xos, Xos, Rr, Xos, Xu, Xu, Xu, Uu, Rr^Pr/, Xu, Uu, Rb, Uu, Rb, Rb^Es, Rb, Uu, Rb, Xu, Rb, Xu, Xu, Uu^Emf, Rr, Rb^Edb, Rr^Edb, Uu^Edb, Uu^Emf, Xos, Rr, Xos, Rr, Rb^Edb, Rb^Edb, Rr^Edb, Rb, Xu, Xu, Uu^Emf, Uu^Em, Uu, Rb, Rb, Rr^Pr\, Rr^Pr\, Rr^Edb, Uu^Edb, Rr^Edb, Rr^Pr/, Xu, Rb, Rb, Rb, Rb^Es, Rb, Xu, Xu, Rr, Rr, Rb^Edb, Rr^Edb, Xu, Rr^Edb, Rb^Edb, Rb^Edb, Rb, Rr, Xu, Xu, Uu^Em, Rb, Rb, Uu^Es, Uu, Xu, Xu, Xu, Xu, Xu, Xu, Xu, Xu, Xu, Xu, Xu
Xu, Xu, Xu, Xu, Xu, Xu, Xu, Xu, Xu, Xu, Xu, Xu, Xu, Xos, Rr^Edb, Rr^Edb, Rr^Edb, Rr, Rr, Xos, Xos, Xu, Uu, Uu, Uu^Es, Rb, Rb, Uu, Rb^Es, Rb, Rb, Rb, Xu, Xu, Xos, Xu, Xu, Uu, Rr, Rr^Edb, Xos, Xos, Xu, Xu, Xu, Xos, Xos, Rr^Edb, Xos, Xos, Xu, Xos, Xos, Xu, Uu^Emf, Uu^Em, Rb, Rb, Rb, Xu, Xu, Rr^Pr/, Rb, Rb, Rb^Es, Rb^Es, Rb, Rb, Rr^Pr/, Rr^Pr/, Uu^Edb, Xu, Rr^Pr\, Rb^Edb, Rb, Rr^Edb, Rb^Edb, Rb^Edb, Rb^Edb, Rb, Rr^Pr/, Xu, Uu, Uu^Em, Rb, Uu, Rr^Pr/, Xu, Xos, Xu, Xu, Xu, Xu, Xu, Xu, Xu, Xu, Xu, Xu
Xu, Xu, Xu, Xu, Xu, Xu, Xu, Xu, Xu, Xu, Xu, Xu, Xu, Rb, Rb^Edb, Uu^Edb, Uu^Edb, Uu, Rr^Pr/, Rr^Pr/, Uu, Xu, Uu^Es, Uu^Es, Rb^Es, Uu, Rb, Rb^Es, Rb, Rb, Rr^Pr/, Rr^Pr/, Rr^Edb, Rb, Rr, Xos, Xu, Xu, Xu, Xu, Xu, Xu, Xu, Xu, Xu, Xu, Xu, Xu, Xu, Xu, Xu, Xos, Xu, Xos, Xos, Xu, Rb, Rb, Rb^Es, Uu, Uu, Uu^Emf, Rb, Rb, Rr^Pr/, Xu, Xos, Xu, Rr, Rb^Edb, Rr^Edb, Rr^Edb, Rr^Edb, Xos, Xos, Rr^Edb, Rr^Edb, Rr^Edb, Xos, Rr^Pr/, Rb, Rb^Es, Rb, Rb, Rr^Pr/, Xos, Rr^Edb, Uu^Edb, Rb^Edb, Xos, Xu, Xu, Xu, Xu, Xu, Xu, Xu, Xu, Xu
Xu, Xu, Xu, Xu, Xu, Xu, Xu, Xu, Xu, Xu, Xu, Xu, Xu, Xu, Xu, Uu^Edb, Xu, Xu, Rb, Rb, Rb, Uu, Rb, Rb, Rb, Rb, Rb, Rb, Xu, Xu, Rb^Edb, Rr^Edb, Rb^Edb, Rb^Edb, Rr^Edb, Rr, Xos, Xu, Xu, Xu, Xu, Xu, Xu, Xu, Xu, Xu, Xu, Xu, Xu, Xu, Xu, Xu, Xu, Xu, Xu, Xu, Xu, Xu, Rb, Rb, Rb, Rb, Xos, Rr^Pr/, Rb, Rr, Rr^Edb, Xos, Xos, Uu^Edb, Uu^Edb, Rr^Edb, Rr^Edb, Rr, Xu, Xu, Xu, Xu, Uu, Rb, Rb, Rb, Xu, Xu, Rb^Edb, Rr^Edb, Rr^Edb, Rb^Edb, Rr^Edb, Uu, Xu, Xu, Xu, Xu, Xu, Xu, Xu, Xu, Xu
Xu, Xu, Xu, Xu, Xu, Xu, Xu, Xu, Xu, Xu, Xu, Xu, Xu, Xu, Xu, Xu, Xu, Rb, Rb^Es, Rb^Es, Rb, Rb, Rb, Uu, Uu, Xu, Xu, Xu, Xu, Rr, Rb^Edb, Rb^Edb, Rb^Edb, Rr^Edb, Xos, Xos, Xu, Xu, Xu, Xu, Xu, Xu, Xu, Xu, Xu, Xu, Xu, Xu, Xu, Xu, Xu, Xu, Xos, Xos, Rr, Uu^Emf, Uu, Xu, Rr^Pr\, Rb, Rb, Rb, Uu^Em, Xu, Rr^Pr\, Rb, Rb, Rr^Edb, Uu^Edb, Xu, Rr^Pr\, Rr^Edb, Rr^Pr/, Rr^Pr/, Rb, Uu^Emf, Uu, Uu, Uu, Uu^Emf, Rr^Pr/, Xu, Xu, Rr, Rb^Edb, Rr^Edb, Rr^Edb, Rr^Edb, Xos, Xos, Xu, Xu, Xu, Xu, Xu, Xu, Xu, Xu, Xu
Xu, Xu, Xu, Xu, Xu, Xu, Xu, Xu, Xu, Xu, Xu, Xu, Xu, Xu, Xu, Xu, Rb^Ii, Rb, Rb, 1 Rb^Es, Rb, Rb, Uu, Uu, Rr^Pr/, Xu, Uu, Xu, Xos, Xu, Xu, Rr^Edb, Xu, Xos, Xu, Xu, Xu, Xu, Xu, Xu, Xu, Xu, Xu, Xu, Xu, Xu, Xu, Xu, Xu, Xu, Xu, Xu, Xos, Rr, Rr, Rb, Rr, Rb, Rr^Pr/, Xu, Rb, Rb, Rb, Uu^Emf, Rr^Pr/, Xu, Rb^Edb, Rb^Edb, Rb^Edb, Uu^Edb, Rr, Xu, Xu, Rb, Uu, Uu, Rb, Rb, Rr^Pr/, Xu, Rr^Edb, Uu^Emf, Rb, Xu, Xu, Rr^Edb, Xos, Xos, Xu, Xu, Xu, Xu, Xu, Xu, Xu, Xu, Xu, Xu, Xu
Xu, Xu, Xu, Xu, Xu, Xu, Xu, Xu, Xu, Xu, Xu, Xu, Xu, Xu, Xu, Rb^Ii, Rb^Ii, Rb, Rb, Rb, Xu, Rb, Xu, Rr^Pr/, Rr^Edb, Uu^Edb, Rr^Edb, Rb, Rr, Xos, Xu, Xu, Xu, Xu, Xu, Xu, Xu, Xu, Xu, Xu, Xu, Xu, Xu, Xu, Xu, Xu, Xu, Xu, Xu, Xu, Xu, Xu, Xu, Xos, Xos, Rr, Xu, Rr^Pr/, Rb^Em, Rb, Uu, Rb, Xos, Rr^Pr/, Rr, Rb^Edb, Rr^Edb, Rr^Edb, Rb^Edb, Rr^Edb, Xu, Xu, Uu^Em, Uu^Em, Rb, Rb, Xu, Rr^Pr/, Rr^Edb, Rr^Edb, Rr^Edb, Rr^Edb, Rr, Rr, Xu, Xu, Xu, Xu, Xu, Xu, Xu, Xu, Xu, Xu, Xu, Xu, Xu, Xu, Xu
Xu, Xu, Xu, Xu, Xu, Xu, Xu, Xu, Xu, Xu, Xu, Xu, Xu, Xu, Xu, Rb^Ii, Xu, Rb^Ii, Xu, Xu, Xu, Xu, Xos, Rr, Rr^Edb, Rr^Edb, Rb^Edb, Rb, Xos, Xos, Xu, Xu, Xu, Xu, Xu, Xu, Xu, Xu, Xu, Xu, Xu, Xu, Xu, Xu, Xu, Xu, Xu, Xu, Xu, Xu, Xu, Xu, Xu, Xu, Xu, Xu, Xu, Uu^Es, Rb^Em, Rb, Xu, Uu, Rb, Rr^Pr\, Rr^Pr\, Rr^Edb, Rr^Edb, Rr^Edb, Rr^Pr/, Rr^Pr/, Rb, Uu, Rb^Em, Rb, Rr^Pr/, Rr^Pr/, Rr^Edb, Uu^Edb, Uu^Edb, Rb^Edb, Uu^Edb, Rb^Edb, Xos, Xos, Xu, Xu, Xu, Xu, Xu, Xu, Xu, Xu, Xu, Xu, Xu, Xu, Xu, Xu, Xu
Xu, Xu, Xu, Xu, Xu, Xu, Xu, Xu, Xu, Xu, Xu, Xu, Xu, Xu, Xu, Xu, Xu, Xu, Xu, Xu, Xu, Xu, Xu, Xu, Xu, Rb^Edb, Xu, Xos, Xu, Xu, Xu, Xu, Xu, Xu, Xu, Xu, Xu, Xu, Xu, Xu, Xu, Xu, Xu, Xu, Xu, Xu, Xu, Xu, Xu, Xu, Xu, Xu, Xu, Xu, Rr, Uu, Rb, Rr^Pr\, Rr^Pr\, Rb, Rb, Uu, Xu, Rb, Uu, Xu, Xu, Rr^Pr/, Rb, Rb, Uu^Em, Uu^Emf, Xos, Xu, Rr, Rb, Rb^Edb, Rb^Edb, Rr^Edb, Rb^Edb, Xu, Xos, Xu, Xu, Xu, Xu, Xu, Xu, Xu, Xu, Xu, Xu, Xu, Xu, Xu, Xu, Xu, Xu, Xu
Xu, Xu, Xu, Xu, Xu, Xu, Xu, Xu, Xu, Xu, Xu, Xu, Xu, Xu, Xu, Xu, Xu, Xu, Xu, Xu, Xu, Xu, Xu, Xu, Xu, Xu, Xu, Xu, Xu, Xu, Xu, Xu, Xu, Xu, Xu, Xu, Xu, Xu, Xu, Xu, Xu, Xu, Xu, Xu, Xu, Xu, Xu, Xu, Xu, Xu, Xu, Xu, Xu, Xos, Xos, Rb, Rr, Rb, Rr, Xu, Xu, Uu, Uu^Emf, Uu, Xu, Uu, Rb, Rb, Rb, Uu, Xu, Xu, Rr, Xos, Xos, Rr^Edb, Rr, Rr^Edb, Xos, Xu, Xu, Xu, Xu, Xu, Xu, Xu, Xu, Xu, Xu, Xu, Xu, Xu, Xu, Xu, Xu, Xu, Xu, Xu, Xu
Xu, Xu, Xu, Xu, Xu, Xu, Xu, Xu, Xu, Xu, Xu, Xu, Xu, Xu, Xu, Xu, Xu, Xu, Xu, Xu, Xu, Xu, Xu, Xu, Xu, Xu, Xu, Xu, Xu, Xu, Xu, Xu, Xu, Xu, Xu, Xu, Xu, Xu, Xu, Xu, Xu, Xu, Xu, Xu, Xu, Xu, Xu, Xu, Xu, Xu, Xu, Xu, Xu, Xu, Xu, Xos, Xos, Rr, Xos, Xos, Rb, Rr^Pr\, Rr^Pr\, Rb, Rb^Em, Uu^Emf, Rb, Rb, Xu, Rr^Pr/, Uu^Edb, Rb^Es, Rb^Edb, Rr, Rr, Xos, Xos, Xos, Xu, Xu, Xu, Xu, Xu, Xu, Xu, Xu, Xu, Xu, Xu, Xu, Xu, Xu, Xu, Xu, Xu, Xu, Xu, Xu, Xu
Xu, Xu, Xu, Xu, Xu, Xu, Xu, Xu, Xu, Xu, Xu, Xu, Xu, Xu, Xu, Xu, Xu, Xu, Xu, Xu, Xu, Xu, Xu, Xu, Xu, Xu, Xu, Xu, Xu, Xu, Xu, Xu, Xu, Xu, Xu, Xu, Xu, Xu, Xu, Xu, Xu, Xu, Xu, Xu, Xu, Xu, Xu, Xu, Xu, Xu, Xu, Xu, Xu, Xu, Xu, Xu, Xu, Xu, Xu, Rr, Rr, Rb, Rb, Rr^Pr\, Xu, Rb, Xos, Rr^Pr/, Rr, Rb^Edb, Rr^Edb, Rr^Edb, Rr^Edb, Rr^Edb, Xos, Xos, Xu, Xos, Xu, Xu, Xu, Xu, Xu, Xu, Xu, Xu, Xu, Xu, Xu, Xu, Xu, Xu, Xu, Xu, Xu, Xu, Xu, Xu, Xu
Xu, Xu, Xu, Xu, Xu, Xu, Xu, Xu, Xu, Xu, Xu, Xu, Xu, Xu, Xu, Xu, Xu, Xu, Xu, Xu, Xu, Xu, Xu, Xu, Xu, Xu, Xu, Xu, Xu, Xu, Xu, Xu, Xu, Xu, Xu, Xu, Xu, Xu, Xu, Xu, Xu, Xu, Xu, Xu, Xu, Xu, Xu, Xu, Xu, Xu, Xu, Xu, Xu, Xu, Xu, Xu, Xu, Xu, Xu, Xos, Xos, Rb, Rr, Rr, Xu, Xos, Xu, Xos, Xos, Rr^Edb, Rr^Edb, Rr^Edb, Xu, Xu, Xu, Xu, Xu, Xu, Xu, Xu, Xu, Xu, Xu, Xu, Xu, Xu, Xu, Xu, Xu, Xu, Xu, Xu, Xu, Xu, Xu, Xu, Xu, Xu, Xu
Xu, Xu, Xu, Xu, Xu, Xu, Xu, Xu, Xu, Xu, Xu, Xu, Xu, Xu, Xu, Xu, Xu, Xu, Xu, Xu, Xu, Xu, Xu, Xu, Xu, Xu, Xu, Xu, Xu, Xu, Xu, Xu, Xu, Xu, Xu, Xu, Xu, Xu, Xu, Xu, Xu, Xu, Xu, Xu, Xu, Xu, Xu, Xu, Xu, Xu, Xu, Xu, Xu, Xu, Xu, Xu, Xu, Xu, Xu, Xu, Xu, Xu, Xu, Xu, Xu, Xu, Xu, Xu, Xu, Xu, Xu, Xu, Xu, Xu, Xu, Xu, Xu, Xu, Xu, Xu, Xu, Xu, Xu, Xu, Xu, Xu, Xu, Xu, Xu, Xu, Xu, Xu, Xu, Xu, Xu, Xu, Xu, Xu, Xu
Xu, Xu, Xu, Xu, Xu, Xu, Xu, Xu, Xu, Xu, Xu, Xu, Xu, Xu, Xu, Xu, Xu, Xu, Xu, Xu, Xu, Xu, Xu, Xu, Xu, Xu, Xu, Xu, Xu, Xu, Xu, Xu, Xu, Xu, Xu, Xu, Xu, Xu, Xu, Xu, Xu, Xu, Xu, Xu, Xu, Xu, Xu, Xu, Xu, Xu, Xu, Xu, Xu, Xu, Xu, Xu, Xu, Xu, Xu, Xu, Xu, Xu, Xu, Xu, Xu, Xu, Xu, Xu, Xu, Xu, Xu, Xu, Xu, Xu, Xu, Xu, Xu, Xu, Xu, Xu, Xu, Xu, Xu, Xu, Xu, Xu, Xu, Xu, Xu, Xu, Xu, Xu, Xu, Xu, Xu, Xu, Xu, Xu, Xu
Xu, Xu, Xu, Xu, Xu, Xu, Xu, Xu, Xu, Xu, Xu, Xu, Xu, Xu, Xu, Xu, Xu, Xu, Xu, Xu, Xu, Xu, Xu, Xu, Xu, Xu, Xu, Xu, Xu, Xu, Xu, Xu, Xu, Xu, Xu, Xu, Xu, Xu, Xu, Xu, Xu, Xu, Xu, Xu, Xu, Xu, Xu, Xu, Xu, Xu, Xu, Xu, Xu, Xu, Xu, Xu, Xu, Xu, Xu, Xu, Xu, Xu, Xu, Xu, Xu, Xu, Xu, Xu, Xu, Xu, Xu, Xu, Xu, Xu, Xu, Xu, Xu, Xu, Xu, Xu, Xu, Xu, Xu, Xu, Xu, Xu, Xu, Xu, Xu, Xu, Xu, Xu, Xu, Xu, Xu, Xu, Xu, Xu, Xu
