Xu, Xu, Xu, Xu, Xu, Xu, Xu, Xu, Xu, Xu, Xu, Xu, Xu, Xu, Xu, Xu, Xu, Xu, Xu, Xu, Xu, Xu, Xu, Xu, Xu, Xu, Xu, Xu, Xu, Xu, Xu, Xu, Xu
Xu, Xu, Xu, Xu, Xu, Xu, Xu, Xu, Xu, Xu, Xu, Xu, Xu, Xu, Xu, Xu, Xu, Xu, Uh, Xu, Uh, Uh, Xu, Xu, Xu, Xu, Xu, Xu, Xu, Xu, Xu, Xu, Xu
Xu, Xu, Xu, Xu, Xu, Xu, Uh, Xu, Uh^Ftp, Uh^Ftp, Rd^Ftp, Xu, Qxua, Uh, Uh, Xu, Uh, Xu, Xu, Uh, Xu, Uh, Xu, Xu, Xu, Xu, Xu, Xu, Xu, Xu, Xu, Xu, Xu
Xu, Xu, Xu, Xu, Qxua, Xu, Rd, Uh, Ds, Ds^Ftp, Ds^Ftp, Rd^Ftp, Rd^Ftp, Ds^Esd, Ds^Edb, Uh, Uh, Xu, Xu, Xu, Xu, Xu, Xu, Xu, Xu, Xu, Xu, Xu, Xu, Xu, Xu, Xu, Xu
Xu, Xu, Xu, Xu, Uu, Xu, Urb^Edb, Ds^Edb, Ds^Edb, Qxua, Ds^Ftp, Ds^Ftp, Rd, Rd, Cdr, Uh, Xu, Xu, Xu, Xu, Xu, Xu, Qxua, Xu, Xu, Xu, Xu, Xu, Xu, Xu, Xu, Xu, Xu
Xu, Xu, Xu, Uh, Ds^Edb, Uu, Uu^Ftp, Urb^Edb, Ds^Edb, Rd^Edb, Rd^Edb, Rd, Dd^Dc, Ds^Dr, Ds^Ftp, Ds^Ftp, Uh, Uh, Uh, Uh, Uh, Qxua, Qxua, Xu, Xu, Xu, Xu, Xu, Xu, Xu, Xu, Xu, Xu
Xu, Xu, Urb, Uh, Rd, Ds^Edb, Cdr, Urb, Urb, Rd, Ds^Esd, Rd^Edb, Ds^Edb, Ds, Ds^Edb, Ds^Ftp, Qxua, Ds^Edb, Dd^Rusy, Ds^Edp, Ds, Cdr, Qxua, Qxua, Ds, Ds, Xu, Xu, Xu, Xu, Xu, Xu, Xu
Xu, Xu, Urb, Urb, Rd, Ds^Edb, Rd, Urb^Dr, Rd^Edb, Ds^Edp, Rd, Ds^Edb, Rd, Ds^Esd, Rd, Ds, Ds^Edb, Ds, Dd^Rusy, Dd^Rusy, Urb, Ds, Urb, Urb, Xu, Uh, Uh, Xu, Xu, Xu, Xu, Xu, Xu
Uh, Urb, Rd, Urb, Urb^Dr, Rd, Rd, Ds^Edp, Rd^Edb, Qxua, Rd, Rd, Cdr, Rd^Edb, Rd^Edb, Ds^Edb, Rd, Dd^Rusy, Dd^Rusy, Dd^Rusy, Urb, Urb, Uh, Uh, Xu, Dd^Rusy, Dd^Rusy, Uh, Xu, Xu, Xu, Xu, Xu
Uh, Uh, Rd, Rd, Urb, Urb, Rd^Edb, Ds^Edb, Rd^Edb, Rd^Edb, Ds^Ftp, Ds, Qxua, Ds^Ftp, Ds^Edb, Rd, Qxua, Rd, Rd^Edb, Rd^Rusy, Urb, Uh, Cdr, Uh, Ds, Ds^Rusy, Ds^Es, Uh, Uh, Xu, Uh, Xu, Xu
Xu, Uh, Uh, Rd, Rd, Rd, Rd, Rd^Edb, Rd, Ds, Qxua, Ds^Ftp, Qxua, Qxua, Ds, Ds, Ds, Rd, Rd, Rd^Edb, Rd, Uh, Uh, Ds, Rd^Es, Rd^Es, Rd, Ds, Cdr, Uh, Uh, Ds, Xu
Xu, Uh, Uh, Urb, Urb, Urb, Urb, Rd^Edb, Rd, Rd, Ds^Edp, Qxua, Rd, Qxua, Qxua, Ds^Edp, Rd^Rusy, Rd^Rusy, Urb^Rusy, Rd, Ds, Rd, Rd, Ds, Dd^Rusy, Dd^Rusy, Rd, Cdr, 2 Kdr, Cdr, Ds, Uh, Xu
Xu, Xu, Urb, 1 Urb, Urb, Urb, Urb, Ds, Ds^Edp, Rd, Rd, Ds, Qxua, Rd, Rd, Rd, Ds^Rusy, Ds^Rusy, Urb^Rusy, Ds^Rusy, Ds, Rd, Ds, Dd^Rusy, Dd^Rusy, Dd^Rusy, Dd^Rusy, Cdr, Cdr, Cdr, Rd, Xu, Xu
Xu, Xu, Urb, Urb, Cdr, Urb^Dr, Urb, Ds^Edp, Urb, Rd, Qxua, Rd, Rd, Rd, Rd, Rd^Edb, Rd^Rusy, Urb^Rusy, Urb^Rusy, Urb, Uh, Uh, Ds, Ds, Ds, Dd^Rusy, Dd^Rusy, Ds, Ds, Ds, Rd, Ds, Ds
Urb, Urb, Urb, Cdr, Kdr, Cdr, Urb, Urb, Ds, Ds^Esd, Ds, Qxua, Rd, Qxua, Qxua, Ds, Rd, Rd^Rusy, Urb, Uh, Cdr, Uh, Uh, Uh, Uh, Dd^Rusy, Dd^Rusy, Dd^Rusy, Cdr, Rd, Rd, Rd, Rd
Uh, Urb, Uh, Uh, Cdr, Cdr, Urb, Urb, Ds^Edb, Ds^Edb, Ds, Rd, Qxua, Ds^Edp, Ds^Edp, Ds^Edp, Rd^Edb, Rd, Rd, Uh, Uh, Uh, Uh, Xu, Xu, Uh, Xu, Ds, Uh, Ds, Xu, Ds, Rd
Xu, Xu, Xu, Uh, Uh, Urb, Urb, Urb, Ds, Ds, Qxua, Qxua, Qxua, Qxua, Qxua, Ds^Esd, Ds, Rd, Urb, Urb, Uh, Uh, Xu, Xu, Xu, Xu, Xu, Xu, Xu, Xu, Xu, Xu, Xu
