Dd, Dd, Dd, Dd, Dd, Dd, Dd, Dd, Dd, Dd, Tptz, Tptz, Tptz, Tptz, Tptz, Tptz, Tptz^Rusy, Tptz, Tptz^Rusy, Tptz, Tptz^Rusy, Tptz^Rusy, Tptz^Rusy, Tptz^Rusy, Tptz^Rusy, Tptz, Tptz, Tptz, Tptz, Tptz^Rusy, Tptz^Rusy, Tptz^Rusy, Tptz, Tptz, Tptz, Tptz, Tptz, Tptz, Tptz^Rusy, Tptz^Rusy, Tptz^Rusy, Tptz, Tptz^Rusy, Tptz^Rusy, Tptz^Rusy, Tptz^Rusy, Tptz^Rusy, Tptz^Rusy, Tptz, Tptz, Tptz, Tptz, Tptz, Tptz, Tptz^Rusy, Tptz^Rusy, Tptz^Rusy, Tptz^Rusy, Tptz^Rusy, Tptz^Rusy, Tptz^Rusy, Tptz, Tptz, Tptz, Tptz^Rusy, Tptz, Tptz
Dd, Dd, Dd, Dd, Dd, Dd, Dd, Dd, Dd^Qov, Dd^Qov, Tptz, Tptz, Tptz, Tptz^Rusy, Tptz^Rusy, Tptz^Rusy, Tptz, Tptz^Rusy, Tptz^Rusy, Tptz^Rusy, Tptz^Rusy, Tptz^Rusy, Tptz^Rusy, Tptz^Rusy, Tptz^Rusy, Tptz^Rusy, Tptz^Rusy, Tptz, Tptz, Tptz^Rusy, Tptz^Rusy, Tptz^Rusy, Tptz, Tptz, Tptz, Tptz, Tptz, Tptz, Tptz^Rusy, Tptz^Rusy, Tptz^Rusy, Tptz, Tptz^Rusy, Tptz^Rusy, Tptz^Rusy, Tptz^Rusy, Tptz^Rusy, Tptz^Rusy, Tptz^Rusy, Tptz, Tptz, Tptz, Tptz^Rusy, Tptz, Tptz^Rusy, Tptz^Rusy, Tptz^Rusy, Tptz^Rusy, Tptz^Rusy, Tptz^Rusy, Tptz^Rusy, Tptz^Rusy, Tptz^Rusy, Tptz^Rusy, Tptz^Rusy, Tptz^Rusy, Tptz^Rusy
Dd, Dd, Dd, Dd, Dd, Dd, Dd^Qov, Dd^Qov, Tptz, Tptz^Qov, Tphz, Tptz, Tptz, Tptz, Tptz, Tptz^Rusy, Tptz^Rusy, Tptz^Rusy, Tptz^Rusy, Tptz^Rusy, Tptz^Rusy, Tptz^Rusy, Tptz^Rusy, Tptz, Tptz, Tptz, Tptz, Tptz, Tptz, Tptz, Tptz, Tptz, Tphz, Tphz, Tphz, Tphz, Tphz, Tptz, Tptz, Tptz^Rusy, Tptz, Tptz, Tptz, Tptz^Rusy, Tptz, Tptz, Tptz, Tptz, Tptz, Tptz, Tphz, Tptz, Tptz, Tptz^Rusy, Tptz, Tptz^Rusy, Tptz^Rusy, Tptz^Rusy, Tptz^Rusy, Tptz^Rusy, Tptz^Rusy, Tptz^Rusy, Tptz^Rusy, Tptz^Rusy, Tptz^Rusy, Tptz^Rusy, Tptz^Rusy
Dd^Qov, Dd^Qov, Dd^Qov, Dd, Dd^Qov, Dd, Dd^Qov, Tptz, Tptz, Tptz, Tphz, Tphz, Tphz, Tptz, Tptz, Tptz, Tptz, Tptz^Rusy, Tptz, Tptz^Rusy, Tptz, Tptz, Tptz, Tptz, Tptz, Tptz, Tphz, Tptz, Tphz, Tptz, Tphz, Tphz, Tphz, Tphz, Tphz, Tphz, Tphz, Tphz, Tphz, Tphz, Tphz, Tphz, Tphz, Tphz, Tphz, Tphz, Tphz, Tphz, Tphz, Tphz, Tphz, Tphz, Tphz, Tptz, Tptz, Tptz, Tptz, Tptz^Rusy, Tptz^Rusy, Tptz^Rusy, Tptz, Tptz^Rusy, Tptz, Tptz, Tptz, Tptz^Rusy, Tptz^Rusy
Dd, Tptz, Tptz, Dd^Qov, Tptz, Dd^Qov, Tptz, Tptz, Tptz, Tptz, Tphz, Tphz, Tphz, Tphz, Tphz, Tptz, Tptz, Tptz, Tptz, Tptz, Tptz, Tptz, Tphz, Tptz, Tphz, Tphz, Tphz, Tphz, Tphz, Tphz, Tphz, Tphz, Tphz, Tphz, Tphz, Tphz, Tphz, Tphz, Tphz, Tphz, Tphz, Tphz, Tphz, Tphz, Tphz, Tphz, Tphz, Tphz, Tphz, Tphz, Tphz, Tphz, Tphz, Tphz, Tphz, Tptz, Tptz, Tptz, Tptz, Tptz, Tptz, Tptz, Tptz, Tptz, Tptz, Tptz, Tptz
Dd, Tptz, Tptz, Tptz, Tptz, Dd^Qov, Tptz, Tptz, Tptz^Rusy, Tptz, Tptz, Tphz, Tphz, Tphz, Tphz, Tphz, Tphz^Tpwz, Tphz, Tphz, Tphz, Tphz, Tphz, Tphz, Tphz, Tphz, Tphz, Tphz, Tphz, Tphz, Tphz, Tphz, Tphz, Tptz, Tptz, Tptz, Tptz, Tptz, Tphz, Tphz, Tphz, Tphz, Tphz, Tphz, Tphz, Tphz, Tphz, Tphz, Tphz, Tphz, Tphz, Tptz, Tphz, Tphz, Tphz, Tphz, Tphz, Tphz, Tphz, Tphz, Tptz, Tphz, Tphz, Tphz, Tphz, Tphz, Tptz, Tphz
Dd, Tptz, Tphz, Tptz, Tphz, Tptz^Qov, Tptz^Rusy, Tptz^Rusy, Tptz^Rusy, Tptz^Rusy, Tptz^Rusy, Tptz, Tptz, Tphz, Tphz, Tphz, Tphz, Tphz, Tphz, Tphz, Tphz, Tphz, Tphz, Tphz, Tphz, Tphz, Tptz, Tphz, Tptz, Tphz, Tptz, Tptz, Tptz^Rusy, Tptz^Rusy, Tptz^Rusy, Tptz^Rusy, Tptz^Rusy, Tptz, Tptz, Tptz, Tptz, Tptz, Tptz, Tptz, Tptz, Tptz, Tptz, Tptz, Tptz, Tptz, Tptz, Tptz, Tptz, Tphz, Tphz, Tphz, Tphz, Tphz, Tphz, Tphz^Tpwz, Tphz, Tphz, Tphz, Tphz, Tphz, Tphz, Tphz
Dd, Tphz, Tptz, Tphz, Tptz, Tptz, Tptz^Rusy, Tptz^Rusy, Tptz^Rusy, Tptz^Rusy, Tptz^Rusy, Tptz^Rusy, Tptz^Rusy, Tptz, Tptz, Tphz, Tphz, Tphz, Tphz, Tphz, Tphz, Tphz, Tptz, Tphz, Tptz, Tptz, Tptz, Tptz, Tptz, Tptz, Tptz^Rusy, Tptz^Rusy, Tptz^Rusy, Tptz^Rusy, Tptz^Rusy, Tptz^Rusy, Tptz^Rusy, Tptz^Rusy, Tptz^Rusy, Tptz^Rusy, Tptz, Tptz, Tptz, Tptz, Tptz, Tptz, Tptz, Tptz, Tptz, Tptz, Tptz, Tptz^Rusy, Tptz^Rusy, Tptz, Tptz, Tphz, Tphz, Tphz, Tphz, Tphz, Tphz, Tphz, Tphz, Tphz, Tphz, Tphz, Tphz
Dd, Tptz, Tptz, Tptz, Tptz, Tptz, Tptz^Rusy, Tptz, Tptz^Rusy, Tptz^Rusy, Tptz, Tptz^Rusy, Tptz^Rusy, Tptz^Rusy, Tptz, Tptz, Tptz, Tptz, Tptz, Tptz, Tptz, Tptz, Tptz^Rusy, Tptz, Tptz^Rusy, Tptz^Rusy, Tptz^Rusy, Tptz^Rusy, Tptz^Rusy, Tptz, Tptz^Rusy, Tptz, Tptz^Rusy, Tptz^Rusy, Tptz^Rusy, Tptz^Rusy, Tptz^Rusy, Tptz^Rusy, Tptz^Rusy, Tptz^Rusy, Tptz, Tptz, Tphz, Tptz, Tphz, Tptz, Tphz, Tptz, Tphz, Tptz, Tptz, Tptz, Tptz, Tptz^Rusy, Tptz, Tptz, Tptz, Tptz, Tptz, Tphz, Tptz, Tptz, Tptz, Tptz, Tptz, Tphz, Tptz
Dd, Tptz, Tptz^Rusy, Tptz, Tptz^Rusy, Tptz, Tptz, Tptz^Rusy, Tptz, Tptz, Tptz, Tptz, Tptz, Tptz^Rusy, Tptz^Rusy, Tptz, Tptz^Rusy, Tptz^Rusy, Tptz^Rusy, Tptz, Tptz^Rusy, Tptz, Tptz^Rusy, Tptz, Tptz, Tptz, Tptz^Rusy, Tptz^Rusy, Tptz^Rusy, Tptz^Rusy, Tptz^Rusy, Tptz^Rusy, Tptz, Tptz^Rusy, Tptz^Rusy, Tptz^Rusy, Tptz^Rusy, Tptz^Rusy, Tptz, Tptz, Tphz, Tphz, Tphz, Tphz^Tpwz, Tphz, Tphz, Tphz, Tphz^Tpwz, Tphz, Tphz, Tphz, Tptz, Tptz, Tptz^Rusy, Tptz^Rusy, Tptz, Tptz^Rusy, Tptz, Tptz^Rusy, Tptz^Rusy, Tptz^Rusy, Tptz, Tptz^Rusy, Tptz, Tptz^Rusy, Tptz^Rusy, Tptz
Dd, Tptz, Tptz, Tptz, Tptz, Tptz^Rusy, Tptz, Tptz, Tptz, Tptz, Tphz, Tptz, Tphz, Tptz, Tphz, Tptz, Tptz, Tptz, Tptz^Rusy, Tptz^Rusy, Tptz^Rusy, Tptz^Rusy, Tptz^Rusy, Tptz, Tptz, Tptz, Tptz, Tptz^Rusy, Tptz, Tptz^Rusy, Tptz^Rusy, Tptz^Rusy, Tptz, Tptz^Rusy, Tptz^Rusy, Tptz^Rusy, Tptz, Tptz, Tphz, Tphz, Tphz, Tphz, Tphz, Tphz, Tphz, Tphz, Tphz, Tphz, Tphz, Tphz, Tphz, Tphz, Tphz, Tptz, Tptz, Tptz^Rusy, Tptz^Rusy, Tptz^Rusy, Tptz^Rusy, Tptz^Rusy, Tptz^Rusy, Tptz, Tptz, Tptz^Rusy, Tptz^Rusy, Tptz, Tptz
Dd, Tptz, Tptz, Tptz, Tptz, Tptz, Tptz, Tptz, Tphz, Tphz, Tphz, Tphz, Tphz, Tphz, Tphz, Tphz, Tphz, Tphz, Tphz^Rusy, Tphz^Rusy, Tphz^Rusy, Tphz^Rusy, Tphz^Rusy, Tphz, Tphz, Tphz, Tphz, Tptz, Tptz, Tptz, Tptz, Tptz, Tptz, Tptz^Rusy, Tptz, Tptz, Tphz, Tphz, Tphz, Tphz, Tphz, Tphz, Gd, Tphz, Dd, Tphz^Tyod, Dd, Tphz, Gd, Tphz, Tphz, Tphz, Tphz, Tphz, Tphz, Tphz, Tphz, Tphz^Rusy, Tphz^Rusy, Tphz^Rusy, Tphz^Rusy, Tphz, Tphz, Tptz, Tptz, Tptz^Rusy, Tptz
Dd, Tptz, Tphz, Tptz, Tphz, Tptz, Tphz, Tphz, Tphz, Tphz, Tphz, Tphz, Tphz, Tphz, Tphz, Tphz, Tphz, Tphz, Tphz^Rusy, Tphz^Rusy, Tphz^Rusy, Tphz^Rusy, Tphz^Rusy, Tphz, Tphz, Tphz, Tphz, Tphz, Tphz^Tpwz, Tphz, Tphz, Tptz, Tphz, Tptz, Tphz, Tphz, Tphz, Tphz, Tphz, Tphz, Gd, Gd, Gd^Fts, Dd^Fts, Dd, 1 Tptz, Dd, Dd, Gd^Fts, Gd, Gd, Tphz, Tphz, Tphz, Tphz, Tphz, Tphz, Tphz^Rusy, Tphz^Rusy, Tphz^Rusy, Tphz^Rusy, Tphz, Tphz, Tphz, Tphz, Tptz, Tphz
Dd, Tphz, Tphz, Tphz, Tphz, Tphz^Tpwz, Tphz, Tphz, Tphz, Tphz, Tptz, Tphz, Tptz, Tphz, Tptz, Tphz, Tphz, Tphz, Tphz^Rusy, Tphz^Rusy, Tphz^Rusy, Tphz^Rusy, Tphz^Rusy, Tphz, Tphz, Tphz, Tphz, Tphz, Tphz, Tphz, Tphz, Tphz, Tphz, Tphz, Tphz, Tphz, Tphz, Tphz, Gd, Gd, Gd^Fts, Gd^Fts, Tptz, Gd^Fts, Tptz, Tptz, Tptz, Gd^Fts, Tptz, Gd^Fts, Gd^Fts, Gd, Gd, Tphz, Tphz, Tphz, Tphz, Tphz^Rusy, Tphz^Rusy, Tphz^Rusy, Tphz^Rusy, Tphz, Tphz, Tphz, Tphz, Tphz, Tphz
Dd, Tphz, Tphz, Tphz, Tphz, Tphz^Tpwz, Tphz, Tphz, Tptz, Tptz, Tptz^Rusy, Tptz, Tptz^Rusy, Tptz, Tptz^Rusy, Tptz, Tptz, Tptz, Tptz^Rusy, Tptz^Rusy, Tptz^Rusy, Tptz^Rusy, Tptz^Rusy, Tptz, Tptz, Tptz, Tptz^Rusy, Tphz, Tphz, Tphz, Tphz, Tphz, Tfhz, Tphz, Tphz, Tphz, Tptz, Tptz, Tptz, Tptz, Gd^Fts, Gd^Fts, Tptz, Tptz, Tptz, Tptz, Tptz, Tptz, Tptz, Gd^Fts, Gd^Fts, Tptz, Tptz, Tptz, Gd, Gd, Gd^Fts, Gd^Rusy, Gd^Rusy, Gd^Rusy, Gd^Fts, Gd, Gd, Tphz, Tphz, Tphz, Tphz
Dd, Tphz, Tptz, Tphz, Tptz, Tphz^Tyod, Tptz, Tptz, Tptz^Rusy, Tptz, Tptz^Rusy, Tptz^Rusy, Tptz^Rusy, Tptz, Tptz^Rusy, Tptz^Rusy, Tptz^Rusy, Tptz, Tptz^Rusy, Tptz^Rusy, Tptz^Rusy, Tptz^Rusy, Tptz, Tptz, Tptz^Rusy, Tptz^Rusy, Tptz^Rusy, Tptz^Rusy, Tptz, Tptz, Tptz, Tphz, Tptz, Tphz, Tptz, Tptz, Tptz, Tptz, Tptz^Rusy, Tptz, Tptz, Gd^Fts, Tptz, Gd^Fts, Gd^Fts, Tptz, Gd^Fts, Gd^Fts, Tptz, Gd^Fts, Tptz, Tptz, Tptz^Rusy, Tptz, Gd^Fts, Gd^Fts, Gd^Fts, Gd^Rusy, Gd^Rusy, Gd^Fts, Gd^Fts, Gd^Fts, Gd^Fts, Tptz, Tptz, Tphz, Tptz
Dd, Tptz, Tptz, Tptz, Tptz, Tptz, Tptz, Tptz^Rusy, Tptz, Tptz, Tptz, Tptz^Rusy, Tptz, Tptz, Tptz^Rusy, Tptz^Rusy, Tptz, Tptz, Tptz, Tptz^Rusy, Tptz^Rusy, Tptz, Tptz, Tptz, Tptz^Rusy, Tptz, Tptz^Rusy, Tptz^Rusy, Tptz^Rusy, Tptz, Tptz^Rusy, Tptz, Tptz^Rusy, Tptz^Xo, Tptz^Rusy, Tptz^Rusy, Tptz^Rusy, Tptz, Tptz, Tptz, Tptz^Rusy, Tptz, Gd^Fts, Cdr, Cdr, Tptz, Cdr, Cdr, Gd^Fts, Tptz, Tptz, Tptz^Rusy, Tptz^Rusy, Tptz^Rusy, Gd^Fts, Tptz, Tptz^Rusy, Tptz, Tptz, Tptz^Rusy, Tptz, Tptz, Gd^Fts, Tptz, Tptz, Tptz, Tptz
Dd, Tptz^Rusy, Tptz^Rusy, Tptz^Rusy, Tptz, Tptz, Tptz^Rusy, Tptz, Tptz, Tptz, Tptz^Rusy, Tptz^Rusy, Tptz^Rusy, Tptz^Rusy, Tptz, Tptz, Tptz, Tptz, Tptz, Tptz, Tptz, Tptz, Tptz, Tptz^Rusy, Tptz^Rusy, Tptz^Rusy, Tptz^Rusy, Tptz^Rusy, Tptz^Rusy, Tptz^Rusy, Tptz^Rusy, Tptz^Rusy, Tptz^Rusy, Tptz^Xo, Tptz^Xo, Tptz^Rusy, Tptz^Rusy, Tptz^Rusy, Tptz^Rusy, Tptz, Tptz, Tptz^Rusy, Gd^Fts, Kdr, Cdr, 2 Kdr, Cdr, Kdr, Gd^Fts, Tptz^Rusy, Tptz^Rusy, Tptz^Rusy, Tptz^Rusy, Tptz^Rusy, Tptz^Rusy, Tptz, Tptz, Tptz^Rusy, Tptz, Tptz, Tptz, Tptz, Tptz, Tptz, Tptz^Rusy, Tptz, Tptz
Dd, Tptz^Rusy, Tptz^Rusy, Tptz^Rusy, Tptz^Rusy, Tptz, Tptz^Rusy, Tptz^Rusy, Tptz^Rusy, Tptz^Rusy, Tptz^Rusy, Tptz^Rusy, Tptz^Rusy, Tptz^Rusy, Tphz, Tptz, Tphz, Tptz, Tptz, Tptz, Tptz, Tptz, Tptz, Tptz, Tptz, Tptz, Tptz, Tptz^Rusy, Tptz^Rusy, Tptz^Rusy, Tptz^Rusy, Tptz^Rusy, Tptz^Rusy, Tptz^Xo, Tptz^Rusy, 3 Tptz^Rusy, Tptz^Rusy, Tptz^Rusy, Tptz, Tptz, Tptz, Tptz, Tptz, Tptz, Tptz, Cdr, Tptz^Rusy, Tptz, Tptz^Rusy, Tptz^Rusy, Tptz^Rusy, Tptz^Rusy, Tptz^Rusy, Tptz^Rusy, Tptz^Rusy, Tptz^Rusy, Tptz^Rusy, Tptz^Rusy, Tptz^Rusy, Tptz^Rusy, Tptz^Rusy, Tptz^Rusy, Tptz^Rusy, Tptz^Rusy, Tptz, Tptz, Tptz
Dd, Tptz, Tptz, Tptz, Tptz, Tptz, Tphz, Tptz^Rusy, Tptz^Rusy, Tptz^Rusy, Tptz^Rusy, Tptz^Rusy, Tptz^Rusy, Tphz, Tphz, Tphz, Tphz, Tphz, Tphz, Tptz, Tphz, Tptz, Tphz, Tptz, Tphz, Tptz, Tphz, Tptz, Tptz^Rusy, Tptz^Rusy, Tptz^Rusy, Tptz^Rusy, Tptz^Xo, Tptz^Xo, Tptz^Rusy, Tptz^Rusy, Tptz^Rusy, Tptz^Rusy, Tphz, Tptz, Tphz, Tptz, Tphz, Tptz, Tptz, Tptz, Tptz, Tptz, Tptz^Rusy, Tptz^Rusy, Tptz^Rusy, Tptz^Rusy, Tptz^Rusy, Tptz^Rusy, Gd^Fts, Tptz^Rusy, Tptz^Rusy, Tptz^Rusy, Gd^Fts, Tptz, Tptz^Rusy, Tptz^Rusy, Gd^Fts, Tptz^Rusy, Tptz^Rusy, Tptz^Rusy, Tptz
Dd, Tptz, Tptz, Tptz, Tphz, Tphz, Tphz, Tphz, Tptz^Rusy, Tptz^Rusy, Tptz^Rusy, Tptz^Rusy, Tptz^Rusy, Tphz, Tphz, Tphz, Tphz, Tphz, Tphz, Tphz, Tphz, Tphz, Tphz, Tphz, Tphz, Tphz, Tphz, Tphz, Tphz, Tptz^Rusy, Tptz^Rusy, Tptz^Rusy, Tptz^Xo, Tptz^Rusy, Tptz, Tptz, Tphz, Tphz, Tphz, Tphz, Tphz, Tphz, Tphz, Tphz, Tphz, Tptz, Tptz, Tptz^Rusy, Tptz, Tptz, Tptz, Tptz^Rusy, Tptz, Gd^Fts, Tptz^Rusy, Gd^Fts, Tptz, Gd^Fts, Tptz, Gd^Fts, Tptz, Gd^Fts, Tptz, Gd^Fts, Tptz, Tptz^Rusy, Tptz
Dd, Tphz, Tphz, Tphz, Tphz, Tphz, Tphz, Tphz, Tptz^Rusy, Tptz^Rusy, Tptz^Rusy, Tptz^Rusy, Tptz^Rusy, Tphz, Tptz, Tphz, Tptz, Tphz, Tphz, Tphz, Tphz, Tphz, Tphz, Tphz, Tphz, Tphz, Tphz, Tphz, Tphz, Tphz, Tphz, Tphz, Tphz, Tphz, Tphz^Tpwz, Tphz, Tphz, Tphz, Tphz, Tphz, Tphz, Tphz, Tphz, Tphz, Tphz, Tphz, Tphz, Tptz, Tphz, Tptz, Tphz, Tptz, Tptz, Tptz^Rusy, Tptz, Tptz, Tptz, Tptz, Tptz, Tptz, Tptz, Tptz, Tptz, Tptz, Tptz, Tptz, Tptz
Dd, Tphz, Tphz, Tphz, Tphz, Tphz, Tptz, Tphz, Tptz^Rusy, Tptz^Rusy, Tptz^Rusy, Tptz^Rusy, Tptz^Rusy, Tptz^Rusy, Tptz^Rusy, Tptz, Tptz, Tptz, Tptz, Tphz, Tptz, Tphz, Tptz, Tphz, Tptz, Tphz, Tptz, Tphz, Tphz, Tphz, Tphz, Tphz, Tphz, Tphz, Tphz, Tphz, Tphz, Tphz, Tptz, Tphz, Tptz, Tphz, Tptz, Tphz, Tphz, Tphz, Tphz, Tphz, Tphz, Tphz, Tphz, Tphz, Tphz, Tptz, Tphz, Tptz, Tphz, Tptz, Tphz, Tphz, Tphz, Tphz, Tphz, Tphz, Tphz, Tphz, Tphz
Dd, Tphz, Tphz, Tphz, Tptz, Tptz, Tptz^Rusy, Tptz^Rusy, Tptz^Rusy, Tptz^Rusy, Tptz^Rusy, Tptz^Rusy, Tptz^Rusy, Tptz^Rusy, Tptz^Rusy, Tptz^Rusy, Tptz^Rusy, Tptz, Tptz^Rusy, Gd^Fts, Gd^Fts, Gd^Fts, Tptz, Gd^Fts, Gd^Fts, Gd^Fts, Tptz, Tptz, Tptz, Tphz, Tphz, Tphz, Tphz, Tphz, Tphz, Tphz, Tptz, Tptz, Tptz, Tptz, Tptz^Rusy, Tptz, Tptz, Tptz, Tptz, Tphz, Tphz, Tphz, Tphz, Tphz, Tphz, Tphz, Tphz, Tphz, Tphz, Tphz, Tphz, Tphz^Tpwz, Tphz, Tphz, Tphz, Tphz, Tphz, Tphz, Tphz, Tphz, Tphz
Dd, Tptz, Tptz, Tptz, Tptz, Tptz^Rusy, Tptz^Rusy, Tptz^Rusy, Tptz^Rusy, Tptz^Rusy, Tptz^Rusy, Tptz^Rusy, Tptz^Rusy, Tptz^Rusy, Tptz^Rusy, Tptz^Rusy, Tptz^Rusy, Tptz, Tptz^Rusy, Gd^Fts, Tptz^Rusy, Gd^Fts, Tptz^Rusy, Gd^Fts, Tptz, Gd^Fts, Tptz, Tptz^Rusy, Tptz^Rusy, Tptz, Tptz, Tptz, Tptz, Tptz, Tptz, Tptz, Tptz^Rusy, Tptz^Rusy, Tptz^Rusy, Tptz^Rusy, Tptz^Rusy, Tptz^Rusy, Tptz, Tptz, Tptz^Rusy, Tptz, Tptz, Tphz, Tptz, Tphz, Tptz, Tphz, Tphz, Tphz, Tphz, Tphz, Tphz, Tphz, Tphz, Tphz, Tphz, Tphz, Tphz, Tphz, Tphz, Tphz, Tphz
Dd, Tptz, Tptz, Tptz, Tptz, Tptz^Rusy, Tptz, Tptz^Rusy, Tptz^Rusy, Tptz^Rusy, Tptz^Rusy, Tptz^Rusy, Tptz^Rusy, Tptz^Rusy, Tptz^Rusy, Tptz^Rusy, Tptz^Rusy, Tptz^Rusy, Tptz, Tptz, Tptz, Tptz, Tptz^Rusy, Tptz, Tptz, Tptz^Rusy, Tptz, Tptz, Tptz, Tptz^Rusy, Tptz^Rusy, Tptz^Rusy, Tptz^Rusy, Tptz^Rusy, Tptz^Rusy, Tptz^Rusy, Tptz^Rusy, Tptz^Rusy, Tptz^Rusy, Tptz^Rusy, Tptz^Rusy, Tptz, Tptz, Tptz, Tptz^Rusy, Tptz, Tptz^Rusy, Tptz, Tptz, Tptz, Tptz, Tptz, Tptz, Tphz, Tptz, Tphz, Tptz, Tphz, Tptz, Tptz, Tptz, Tptz, Tptz, Tptz, Tptz, Tptz, Tptz
Dd, Tptz, Tptz, Tptz^Rusy, Tptz^Rusy, Tptz^Rusy, Tptz, Tptz, Tptz^Rusy, Tptz^Rusy, Tptz^Rusy, Tptz^Rusy, Tptz^Rusy, Tptz^Rusy, Tptz^Rusy, Tptz^Rusy, Tptz^Rusy, Tptz^Rusy, Tptz, Tptz^Rusy, Gd^Fts, Tptz, Gd^Fts, Tptz^Rusy, Gd^Fts, Tptz, Tptz^Rusy, Tptz, Tptz, Tptz^Rusy, Tptz, Tptz^Rusy, Tptz^Rusy, Tptz^Rusy, Tptz^Rusy, Tptz^Rusy, Tptz^Rusy, Tptz^Rusy, Tptz^Rusy, Tptz^Rusy, Tptz^Rusy, Tptz, Tptz, Tptz, Tptz^Rusy, Tptz^Rusy, Tptz^Rusy, Tptz^Rusy, Tptz^Rusy, Tptz^Rusy, Tptz^Rusy, Tptz, Tptz, Tptz, Tptz^Rusy, Tptz, Tptz^Rusy, Tptz, Tptz^Rusy, Tptz^Rusy, Tptz^Rusy, Tptz, Tptz^Rusy, Tptz, Tptz, Tptz, Tptz
Dd, Tptz, Tptz, Tptz, Tptz, Tptz, Tptz, Tptz, Tptz, Tptz^Rusy, Tptz, Tptz, Tptz, Tptz^Rusy, Tptz, Tptz, Tptz, Tptz, Tptz^Rusy, Tptz, Tptz, Tptz, Tptz, Tptz, Tptz, Tptz, Tptz, Tptz^Rusy, Tptz, Tptz, Tptz, Tptz^Rusy, Tptz^Rusy, Tptz^Rusy, Tptz, Tptz^Rusy, Tptz^Rusy, Tptz^Rusy, Tptz, Tptz, Tptz, Tptz, Tptz^Rusy, Tptz^Rusy, Tptz, Tptz^Rusy, Tptz^Rusy, Tptz^Rusy, Tptz^Rusy, Tptz^Rusy, Tptz^Rusy, Tptz, Tptz, Tptz, Tptz, Tptz^Rusy, Tptz^Rusy, Tptz^Rusy, Tptz, Tptz^Rusy, Tptz^Rusy, Tptz^Rusy, Tptz, Tptz, Tptz, Tptz^Rusy, Tptz
Dd, Tptz, Tphz, Tptz, Tphz, Tptz, Tptz, Tptz, Tptz, Tptz, Tptz, Tptz, Tptz, Tptz, Tptz, Tptz, Tptz, Tptz, Tptz, Tptz, Tptz, Tptz, Tptz, Tptz, Tptz, Tptz, Tptz, Tptz, Tptz, Tptz, Tptz, Tptz, Tptz, Tptz, Tptz, Tptz, Tptz, Tptz, Tptz, Tptz, Tptz, Tptz, Tptz, Tptz, Tptz, Tptz, Tptz, Tptz, Tptz, Tptz^Rusy, Tptz, Tptz, Tptz, Tptz, Tptz^Rusy, Tptz^Rusy, Tptz^Rusy, Tptz^Rusy, Tptz^Rusy, Tptz, Tptz, Tptz, Tptz, Tptz, Tptz, Tptz, Tptz
Dd, Tphz, Tphz, Tphz, Tphz, Tphz, Tphz, Tphz, Tphz, Tptz, Tphz, Tptz, Tphz, Tphz, Tphz, Tphz, Tphz, Tptz, Tphz, Tptz, Tphz, Tphz, Tphz, Tphz, Tphz, Tptz, Tphz, Tptz, Tphz, Tphz, Tphz, Tphz, Tphz, Tptz, Tphz, Tptz, Tphz, Tphz, Tphz, Tphz, Tphz, Tptz, Tphz, Tptz, Tphz, Tphz, Tphz, Tphz, Tphz, Tptz, Tphz, Tptz, Tphz, Tphz, Tphz^Rusy, Tphz^Rusy, Tphz^Rusy, Tptz^Rusy, Tphz^Rusy, Tptz^Rusy, Tphz^Rusy, Tphz, Tphz, Tphz, Tphz, Tphz, Tphz
Dd, Tphz, Tphz, Tphz, Tphz, Tphz, Tphz, Tphz, Tphz, Tphz, Tphz, Tphz, Tphz, Tphz, Tphz, Tphz, Tphz, Tphz, Tphz, Tphz, Tphz, Tphz, Tphz, Tphz, Tphz, Tphz, Tphz, Tphz, Tphz, Tphz, Tphz, Tphz, Tphz, Tphz, Tphz, Tphz, Tphz, Tphz, Tphz, Tphz, Tphz, Tphz, Tphz, Tphz, Tphz, Tphz, Tphz, Tphz, Tphz, Tphz, Tphz, Tphz, Tphz, Tphz, Tphz^Rusy, Tphz^Rusy, Tphz^Rusy, Tphz^Rusy, Tphz^Rusy, Tphz^Rusy, Tphz^Rusy, Tphz, Tphz, Tphz, Tphz, Tphz, Tphz
Dd, Tphz, Tphz, Tphz, Tphz, Tphz, Tphz, Tphz, Tphz, Tphz, Tphz, Tphz, Tphz, Tphz, Tphz, Tphz, Tphz, Tphz, Tphz, Tphz, Tphz, Tphz, Tphz, Tphz, Tphz, Tphz, Tphz, Tphz, Tphz, Tphz, Tphz, Tphz, Tphz, Tphz, Tphz, Tphz, Tphz, Tphz, Tphz, Tphz, Tphz, Tphz, Tphz, Tphz, Tphz, Tphz, Tphz, Tphz, Tphz, Tphz, Tphz, Tphz, Tphz, Tphz, Tphz^Rusy, Tphz^Rusy, Tphz^Rusy, Tphz^Rusy, Tphz^Rusy, Tphz^Rusy, Tphz^Rusy, Tphz, Tphz, Tphz, Tphz, Tphz, Tphz
Dd, Tphz, Dd, Tphz, Dd, Tphz, Tphz, Tphz, Tphz, Tphz, Tphz, Tphz, Tphz, Tphz, Tphz, Tphz, Tphz, Tphz, Tphz, Tphz, Tphz, Tphz, Tphz, Tphz, Tphz, Tphz, Tphz, Tphz, Tphz, Tphz, Tphz, Tphz, Tphz, Tphz, Tphz, Tphz, Tphz, Tphz, Tphz, Tphz, Tphz, Tphz, Tphz, Tphz, Tphz, Tphz, Tphz, Tphz, Tphz, Tphz, Tphz, Tphz, Tphz, Tphz, Tphz^Rusy, Tphz^Rusy, Tphz^Rusy, Tphz^Rusy, Tphz^Rusy, Tphz^Rusy, Tphz, Tphz, Tphz, Tphz, Tphz, Tphz, Tphz
Dd, Dd, Dd, Dd, Dd, Dd, Dd, Dd, Dd, Tphz, Dd, Tphz, Dd, Dd, Dd, Dd, Dd, Tphz, Dd, Tphz, Dd, Dd, Dd, Dd, Dd, Tphz, Dd, Tphz, Dd, Dd, Dd, Dd, Dd, Tphz, Dd, Tphz, Dd, Dd, Dd, Dd, Dd, Tphz, Dd, Tphz, Dd, Dd, Dd, Dd, Dd, Tphz, Dd, Tphz, Dd, Dd^Rusy, Dd^Rusy, Dd^Rusy, Dd^Rusy, Tphz^Rusy, Dd^Rusy, Tphz^Rusy, Dd^Rusy, Dd, Dd, Dd, Dd, Dd, Dd
Dd, Dd, Dd^Edp, Dd, Dd^Edp, Dd, Dd, Dd, Dd, Dd, Dd, Dd, Dd, Dd, Dd, Dd, Dd, Dd, Dd, Dd, Dd, Dd, Dd, Dd^Es, Dd, Dd, Dd, Dd^Edp, Dd^Edp, Dd^Edp, Dd, Dd, Dd^Es, Dd, Dd, Dd, Dd, Dd, Dd^Rusy, Dd, Dd, Dd, Dd^Edp, Dd, Dd^Edp, Dd^Edp, Dd^Edp, Dd, Dd, Dd, Dd, Dd, Dd, Dd^Rusy, Dd^Rusy, Dd^Rusy, Dd^Rusy, Dd^Rusy, Dd^Rusy, Dd^Rusy, Dd^Rusy, Dd, Dd, Dd, Dd^Es, Dd, Dd
Dd, Dd, Dd^Rusy, Dd^Es, Dd^Rusy, Dd, Dd, Dd, Dd^Rusy, Dd, Dd, Dd, Dd^Edb, Dd^Edb, Dd^Es, Dd, Dd, Dd, Dd, Dd, Dd^Rusy, Dd^Rusy, Dd^Rusy, Dd, Dd^Es, Dd^Rusy, Dd^Rusy, Dd^Edp, Dd^Edp, Dd, Dd, Dd^Rusy, Dd^Xo, Dd, Dd^Xo, Dd, Dd, Dd, Dd, Dd, Dd, Dd^Edp, Dd, Dd^Edp, Dd, Dd^Edp, Dd, Dd, Dd, Dd, Dd^Xo, Dd, Dd^Edp, Dd^Edp, Dd^Edp, Dd^Rusy, Dd^Rusy, Dd^Rusy, Dd^Rusy, Dd^Rusy, Dd^Rusy, Dd^Rusy, Dd^Edp, Dd^Edp, Dd^Es, Dd, Dd^Edp
Dd, Dd, Dd, Dd, Dd^Edp, Dd, Dd^Edp, Dd, Dd, Dd^Es, Dd, Dd^Edb, Dd^Edb, Dd^Edb, Dd, Dd, Dd^Es, Dd^Edp, Dd, Dd, Dd^Rusy, Dd^Rusy, Dd^Rusy, Dd^Rusy, Dd^Rusy, Dd^Rusy, Dd, Dd, Dd, Dd, Dd, Dd, Dd^Xo, Dd^Xo, Dd^Xo, Dd, Dd^Es, Dd, Dd^Edp, Dd^Rusy, Dd, Dd^Rusy, Dd^Rusy, Dd^Rusy, Dd^Rusy, Dd, Dd, Dd^Es, Dd, Dd^Xo, Dd^Xo, Dd^Xo, Dd^Rusy, Dd, Dd^Edp, Dd^Es, Dd^Rusy, Dd^Rusy, Dd^Rusy, Dd^Rusy, Dd^Rusy, Dd^Rusy, Dd^Rusy, Dd^Edp, Dd^Edp, Dd^Edp, Dd
Dd, Dd, Dd^Rusy, Dd^Edp, Dd^Es, Dd^Edp, Dd^Edp, Dd^Edp, Dd, Dd, Dd, Dd^Edb, Dd, Dd, Dd, Dd^Es, Dd^Xo, Dd^Xo, Dd^Edp, Dd^Rusy, Dd^Rusy, Dd^Rusy, Dd, Dd^Rusy, Dd^Rusy, Dd, Dd, Dd, Dd^Edp, Dd, Dd^Rusy, Dd, Dd^Xo, Dd^Xo, Dd^Xo, Dd, Dd, Dd^Edp, Dd^Es, Dd, Dd^Edp, Dd^Rusy, Dd^Rusy, Dd^Rusy, Dd^Es, Dd, Dd, Dd, Dd, Dd^Xo, Dd^Ruty, Dd^Xo, Dd^Rusy, Dd^Rusy, Dd^Edp, Dd^Es, Dd^Rusy, Dd^Rusy, Dd^Rusy, Dd, Dd^Rusy, Dd^Rusy, Dd^Rusy, Dd^Es, Dd^Edp, Dd, Dd
Dd, Dd^Rusy, Dd^Rusy, Dd^Rusy, Dd, Dd^Edp, Dd^Edp, Dd^Rusy, Dd, Dd^Rusy, Dd, Dd, Dd, Dd^Rusy, Dd, Dd^Xo, Dd^Xo, Dd^Xo, Dd^Edp, Dd, Dd^Edp, Dd^Es, Dd, Dd, Dd, Dd^Rusy, Dd, Dd, Dd, Dd, Dd, Dd, Dd^Xo, Dd^Xo, Dd^Xo, Dd, Dd^Rusy, Dd^Rusy, Dd^Rusy, Dd^Edp, Dd^Edp, Dd, Dd, Dd^Rusy, Dd, Dd, Dd^Rusy, Dd, Dd, Dd^Xo, Dd^Xo, Dd^Xo, Dd^Rusy, Dd^Es, Dd^Rusy, Dd, Dd^Edp, Dd^Rusy, Dd^Edp, Dd^Es, Dd^Rusy, Dd^Rusy, Dd^Es, Dd, Dd, Dd, Dd
Dd^Rusy, Dd^Rusy, Dd^Rusy, Dd^Rusy, Dd^Edp, Dd^Edp, Dd^Edp, Dd^Edp, Dd, Dd, Dd, Dd, Dd^Edp, Dd, Dd, Dd^Xo, Dd^Xo, Dd^Xo, Dd, Dd^Rusy, Dd^Edp, Dd, Dd, Dd, Dd, Dd, Dd^Edp, Dd^Edp, Dd, Dd, Dd, Dd, Dd^Xo, Dd^Ruty, Dd^Xo, Dd, Dd, Dd, Dd, Dd^Edp, Dd^Edp, Dd^Edp, Dd^Edp, Dd^Es, Dd, Dd, Dd^Rusy, Dd, Dd, Dd, Dd, Dd, Dd^Xo, Dd^Xo, Dd^Rusy, Dd^Rusy, Dd, Dd, Dd^Edp, Dd, Dd^Rusy, Dd^Rusy, Dd^Xo, Dd^Rusy, Dd, Dd^Es, Dd
Dd^Rusy, Dd^Rusy, Dd^Rusy, Dd, Dd, Dd, Dd^Rusy, Dd^Edp, Dd^Edp, Dd^Edp, Dd, Dd, Dd, Dd^Edp, Dd, Dd^Xo, Dd^Ruty, Dd^Xo, Dd, Dd^Edp, Dd^Es, Dd, Dd, Dd, Dd^Rusy, Dd^Rusy, Dd, Dd^Rusy, Dd, Dd^Rusy, Dd^Edp, Dd^Edp, Dd, Dd^Xo, Dd^Rusy, Dd^Rusy, Dd^Es, Dd^Edp, Dd^Edp, Dd^Edp, Dd^Edp, Dd, Dd, Dd, Dd^Rusy, Dd^Rusy, Dd, Dd, Dd, Dd, Dd, Dd^Xo, Dd^Xo, Dd^Xo, Dd^Edp, Dd^Rusy, Dd^Rusy, Dd, Dd^Es, Dd, Dd, Dd^Xo, Dd^Xo, Dd^Xo, Dd, Dd, Dd
Dd^Rusy, Dd^Rusy, Dd^Rusy, Dd^Rusy, Dd^Rusy, Dd^Rusy, Dd, Dd^Rusy, Dd, Dd, Dd, Dd, Dd, Dd, Dd, Dd^Xo, Dd^Xo, Dd^Xo, Dd, Dd, Dd, Dd, Dd^Rusy, Dd, Dd^Rusy, Dd, Dd^Es, Dd, Dd, Dd, Dd^Edp, Dd^Es, Dd, Dd, Dd^Es, Dd^Rusy, Dd^Rusy, Dd^Rusy, Dd^Edp, Dd, Dd^Edp, Dd^Edp, Dd^Rusy, Dd^Rusy, Dd^Rusy, Dd, Dd^Rusy, Dd, Dd, Dd, Dd^Rusy, Dd^Xo, Dd^Xo, Dd^Xo, Dd^Rusy, Dd^Rusy, Dd^Edp, Dd, Dd, Dd, Dd, Dd^Xo, Dd^Ruty, Dd^Xo, Dd, Dd^Es, Dd
Dd^Rusy, Dd^Rusy, Dd^Rusy, Dd^Rusy, Dd^Rusy, Dd^Rusy, Dd^Rusy, Dd^Rusy, Dd^Rusy, Dd, Dd^Rusy, Dd^Rusy, Dd, Dd, Dd^Rusy, Dd^Rusy, Dd^Es, Dd^Rusy, Dd^Es, Dd, Dd, Dd, Dd, Dd, Dd, Dd^Rusy, Dd^Es, Dd^Rusy, Dd, Dd, Dd^Edp, Dd^Rusy, Dd, Dd, Dd^Rusy, Dd^Rusy, Dd, Dd, Dd^Edp, Dd^Edp, Dd, Dd^Rusy, Dd^Es, Dd^Rusy, Dd^Rusy, Dd^Rusy, Dd^Es, Dd^Rusy, Dd, Dd, Dd, Dd^Xo, Dd^Ruty, Dd^Xo, Dd^Edp, Dd^Es, Dd, Dd, Dd, Dd^Rusy, Dd, Dd^Xo, Dd^Xo, Dd^Xo, Dd, Dd^Es, Dd
Dd^Rusy, Dd^Rusy, Dd^Rusy, Dd^Rusy, Dd^Rusy, Dd^Rusy, Dd^Rusy, Dd^Rusy, Dd^Rusy, Dd^Rusy, Dd^Rusy, Dd^Rusy, Dd^Rusy, Dd^Rusy, Dd^Rusy, Dd^Rusy, Dd^Rusy, Dd^Rusy, Dd^Rusy, Dd, Dd^Es, Dd^Edp, Dd^Edp, Dd^Edp, Dd, Dd^Rusy, Dd, Dd, Dd, Dd, Dd, Dd, Dd, Dd, Dd, Dd, Dd, Dd, Dd, Dd, Dd, Dd^Rusy, Dd^Rusy, Dd^Rusy, Dd, Dd, Dd, Dd, Dd, Dd, Dd, Dd^Xo, Dd^Xo, Dd^Xo, Dd^Rusy, Dd, Dd, Dd^Edp, Dd, Dd, Dd, Dd, Dd, Dd^Rusy, Dd, Dd, Dd
Dd^Rusy, Dd^Rusy, Dd^Rusy, Dd^Rusy, Dd^Rusy, Dd^Rusy, Dd^Rusy, Dd^Rusy, Dd^Rusy, Dd^Rusy, Dd^Rusy, Dd^Rusy, Dd^Rusy, Dd^Rusy, Dd^Rusy, Dd^Rusy, Dd^Rusy, Dd^Rusy, Dd^Rusy, Dd, Dd^Edp, Dd^Edp, Dd^Edp, Dd^Edp, Dd^Edp, Dd, Dd, Dd, Dd, Dd^Edp, Dd, Dd, Dd, Dd, Dd, Dd, Dd, Dd, Dd, Dd, Dd, Dd, Dd, Dd, Dd, Dd^Es, Dd, Dd, Dd, Dd, Dd, Dd, Dd, Dd, Dd, Dd, Dd, Dd, Dd, Dd, Dd, Dd, Dd, Dd, Dd, Dd, Dd
Dd^Rusy, Dd^Rusy, Dd^Rusy, Dd^Rusy, Dd^Rusy, Dd, Dd^Rusy, Dd^Rusy, Dd^Rusy, Dd, Dd, Dd^Rusy, Dd, Dd, Dd^Rusy, Dd^Rusy, Dd^Rusy, Dd^Rusy, Dd^Rusy, Dd, Dd, Dd, Dd, Dd, Dd, Dd, Dd, Dd, Dd, Dd, Dd, Dd, Dd, Dd, Dd, Dd, Dd, Dd, Dd, Dd, Dd, Dd, Dd, Dd, Dd, Dd, Dd, Dd, Dd, Dd, Dd, Dd, Dd, Dd, Dd, Dd, Dd, Dd, Dd, Dd, Dd, Dd, Dd, Dd, Dd, Dd, Dd
