Mdd, Mdd, Mdd, Mdd, Mdd, Mdd, Mdd, Dd, Gd^Ftd, Mdd, Dd, Dd, Rd, Rd, Dd, Dd, Dd, Dd, Gd^Ftd, Hhd^Ftd, Mdd, Mdd, Mdd, Dd, Mdd, Mdd, Mdd, Dd, Hhd, Hhd, Hhd, Hhd, Dd, Dd, Dd^Ftd, Dd, Gd, Dd, Gd^Ftd, Dd, Gd^Ftd, Gd^Qov, Dd^Ftd, Xzg3^Qov, Xzg3^Qov, Xzg3, Xzg3, Xzg3, Xzg3, Xzg3, Xzg3, Xzg3, Xzg3
Mdd, Mdd, Mdd, Mdd, Mdd, Mdd, Hhd^Ftd, Gd^Ftd, Gd^Ftd, Gd^Ftd, Dd, Dd, Rd, Rd, Dd, Dd^Edp, Dd, Gd^Ftd, Hhd^Ftd, Hhd^Ftd, Mdd, Mdd, Mdd, Mdd, Hhd, Mdd, Mdd, Mdd, Hhd, Hhd, Dd^Ftd, Dd, Dd^Ftd, Dd^Ftd, Gd^Edp, Gd^Ftd, Gd^Ftd, Gd^Ftd, Dd, Dd, Dd^Ftd, Gd^Ftd, Xzg3^Qov, Xzg3^Qov, Xzg3, Xzg3^Es, Xzg2, Xzg3, Xzg2, Xzg3^Es, Xzg2, Xzg3, Xzg3
Mdd, Mdd, Mdd, Mdd, Mdd, Mdd, Mdd, Hhd^Ftd, Gd^Ftd, Dd^Edp, Dd, Rd, Rd, 1 Dd, Dd, Dd^Edp, Dd^Edp, Dd^Edp, Hhd^Ftd, Mdd, Mdd, Mdd, Mdd, Mdd, Hhd, Hhd, Hhd, Hhd, Mdd, Mdd, Mdd, Mdd, Dd^Ftd, Dd^Edp, Dd, Gd^Ftd, Gd^Ftd, Gd^Ftd, Dd^Ftd, Xzg3^Qov, Xzg3^Qov, Xzg3, Xzg3, Xzg2^Qov, Xzg2, Xzg2, Xzg2^Es, Xzg2, Xzgg, Xzg2, Xzg2, Xzg2, Xzg2
Mdd, Mdd, Mdd, Mdd, Hhd^Ftd, Mdd, Hhd^Ftd, Hhd^Ftd, Hhd^Ftd, Dd, Ce, Rd, Rd, Dd, Dd, Dd^Edp, Dd, Hhd^Ftd, Mdd, Mdd, Mdd, Mdd, Mdd, Mdd, Hhd, Mdd, Mdd, Mdd, Mdd, Hhd, Mdd, Dd^Edp, Dd^Edp, Dd^Vdt, Dd^Ftd, Dd^Edp, Dd, Dd, Xzg3^Qov, Xzg3^Qov, Xzg3, Xzg3, Xzg2^Qov, Xzg2^Qov, Xzgg, Xzg2, Xzgg, Xzgg, Xzgg^Es, Xzgg, Xzgg, Xzgg, Xzgg^Qov
Mdd, Mdd, Mdd, Mdd, Hhd, Hhd^Ftd, Hhd^Ftd, Hhd^Ftd, Hhd^Ftd, Ce, Ket, Ce, Dd, Rd, Rd, Dd, Dd, Hhd^Ftd, Mdd, Cdr, Hhd, Mdd, Mdd, Mdd, Hhd, Mdd, Hhd, Mdd, Hhd^Edp, Dd^Edp, Dd^Edp, Dd^Edp, Dd, Dd^Ftd, Dd^Ftd, Dd^Edp, Dd^Es, Dd^Ftd, Xzg3^Qov, Xzg3, Xzg2^Qov, Xzg2^Qov, Xzg2, Xzgg, Xzgg^Es, Xzgg, Xzg^Qov, Xzgg, Xzg^Qov, Xzgg^Qov, Xzg^Qov, Xzg^Qov, Xzg^Qov
Mdd, Mdd, Hhd, Hhd, Re, Rd, Mdd, Mdd, Mdd, Ce, Ce, Ce, Dd, Re, Re, Dd, Mdd, Mdd, Mdd, Hhd, Hhd^Ftd, Mdd, Mdd, Mdd, Hhd, Hhd^Ftd, Dd^Vdr, Hhd, Dd^Edp, Dd^Edp, Re, Re, Dd, Dd, Dd, Dd, Dd^Es, Dd^Es, Dd, Xzg3^Qov, Xzg3, Xzg2^Qov, Xzgg^Qov, Xzgg^Qov, Xzg^Qov, Xzg^Qov, Xzg, Xzg^Qov, Xzg, Xzg^Qov, Xzg^Es, Re, Xzg
Mdd, Mdd, Hhd, Re, Hhd, Dd, Mdd, Mdd, Mdd, Mdd, Mdd, Dd, Mdd, Rd^Rusy, Re, Re, Hhd, Mdd, Cdr, Hhd, Hhd^Ftd, Hhd^Ftd, Hhd^Ftd, Mdd, Gd^Ftd, Hhd^Ftd, Dd^Es, Dd, Dd, Re, Dd, Dd, Rd, Dd, Rd, Rd, Re, Dd^Es, Re, Rd, Xzg2, Xzg2^Qov, Xzg2, Xzgg^Es, Xzgg, Xzg^Qov, Xzg, Xzg^Es, Xzg, Xzg, Rb, Re, Xzg
Hhd, Hhd, Hhd, Re, Rd, Hhd, Hhd, Mdd, Hhd, Hhd, Hhd^Ftd, Cdr, Hhd, Hhd, Re, Dd, Hhd, Cdr, Dd^Es, Dd^Edp, Dd, Dd^Vdr, Dd^Ftd, Gd^Ftd, Gd^Ftd, Gd^Ftd, Dd, Dd, Rd, Rd, Dd, Dd, Dd, Dd, Dd, Rd, Dd, Re, Dd, Rd, Re, Re, Rd, Re, Re, Xzg, Xzg, Re^Es, Re^Edb, Re^Edb, Rb, Rb, Xzg
Dd, Hhd, Dd, Dd, Rd, Dd, Dd, Dd^Vdr, Dd, Dd^Ftd, Dd^Edp, Hhd^Ftd, Dd^Rusy, Dd, Re, Re, Dd, Hhd, Dd^Edp, Dd, Rd, Dd, Dd^Es, Dd, Dd, Dd, Dd, Dd, Dd, Dd, Dd, Gd^Ftd, Gd^Ftd, Gd^Ftd, Dd, Gd^Ftd, Dd, Dd, Dd, Rd, Xzg3, Xzg2, Xzgg^Es, Xzgg, Re, Xzg, Re, Re^Edb, Rb^Edb, Rb, Re^Edb, Re, Re
Dd, Dd, Dd, Rd, Rd, Dd, Dd, Dd, Rd, Dd, Re, Dd^Rusy, Dd, Rd, Rd, Dd, Dd, Dd^Edp, Dd, Dd, Rd, Rd, Rd, Rd, Rd, Rd, Dd^Edp, Dd, Gd, Dd, Gd, Dd^Vdt, Gd^Edp, Gd^Ftd, Dd^Es, Dd, Dd, Xzg3^Qov, Xzg3^Qov, Xzg3^Qov, Xzg2^Qov, Xzg2^Qov, Xzgg^Qov, Xzgg, Xzgg, Xzg, Xzg, Xzg^Es, Re, Rb^Edb, Xzg, Xzg^Es, Xzg
Dd, Dd^Edp, Dd, Cdr, Re, Re, Dd, Dd, Dd, Rd, Dd, Re, Re, Dd, Dd, Dd, Re, Re, Re, Re, Rd, Dd, Dd, Rd, Dd, Cdr, Dd, Hhd, Gd^Edp, Gd^Ftd, Dd^Ftd, Gd^Ftd, Dd^Edp, Dd, Xzg3^Qov, Xzg3^Qov, Xzg3^Qov, Xzg3^Qov, Xzg2, Xzg2, Xzg2^Qov, Xzgg^Qov, Xzgg^Qov, Xzg^Qov, Xzg^Qov, Xzg^Qov, Xzg, Re, Xzg^Edb, Re^Edb, Re^Edb, Xzg^Edb, Xzg
Dd, Dd, Rd, Dd, Re, Rd, Cdr, Dd, Dd^Vdr, Dd, Hhd, Dd, Hhd, Dd, Dd^Vdr, Dd, Dd, Re, Dd, Rd, Dd, Dd, Cdr, Rd, Rd, Dd^Es, Hhd, Hhd, Gd^Ftd, Gd^Edp, Dd, Dd^Edp, Xzg3^Qov, Dd, Xzg3^Qov, Xzg3, Xzg2, Xzg3, Xzg2, Xzg2, Xzgg^Es, Xzgg, Xzgg^Qov, Xzg^Qov, Xzg^Es, Xzg, Re, Re, Rb, Xzg^Edb, Re, Xzg, Xzgg^Qov
Rd, Dd, Rd, Re, Dd, Dd, Gd, Dd, Gd^Edp, Hhd, Mdd, Hhd, Hhd, Hhd^Edp, Hhd^Edp, Dd^Edp, Hhd, Dd, Dd, Dd, Dd, Dd, Dd, Rd, Dd, Dd^Es, Dd^Edp, Dd^Ftd, Dd^Edp, Dd, Xzg3^Qov, Xzg3^Qov, Xzg3^Qov, Xzg3^Qov, Xzg3^Es, Xzg2, Xzg2^Es, Xzg2^Es, Xzgg, Xzgg, Xzgg, Xzgg^Qov, Xzg^Qov, Xzg^Qov, Xzg^Edb, Xzg^Es, Xzg^Es, Rb, Rb^Edb, Rb, Xzg, Xzg^Es, Xzgg^Qov
Rd, Rd, Dd, Rd, Dd^Edp, Gd, Gd^Edp, Gd^Ftd, Hhd, Mdd, Mdd, Mdd, Mdd, Mdd, Mdd, Hhd^Ftd, Hhd^Ftd, Dd, Dd^Ftd, Dd, Dd, Dd, Re, Rd, Dd, Dd, Dd, Dd^Ftd, Dd^Edp, Dd, Xzg3^Qov, Xzg3^Qov, Xzg2, Xzg3, Xzg2, Xzg2, Xzgg, Xzgg, Xzg^Qov, Xzgg, Xzg^Qov, Xzgg^Qov, Xzg^Qov, Xzg, Xzg^Edb, Re, Xzg^Es, Rb^Edb, Re^Edb, Xzg^Edb, Xzg, Xzg, Xzgg^Qov
Dd, Dd, Dd, Dd, Dd, Dd, Gd^Edp, Hhd^Ftd, Hhd^Ftd, Mdd^Ftd, Mdd, Mdd, Mdd, Mdd, Mdd, Mdd, Dd^Ftd, Dd^Ftd, Dd^Ftd, Dd, Dd, Dd, Rd, Dd, Rd, Dd, Dd, Dd, Xzg3^Qov, Xzg3^Qov, Xzg3, Xzg2, Xzgg, Xzg2, Xzgg, Xzgg, Xzg^Qov, Xzg^Qov, Xzg, Xzg^Qov, Xzg, Xzg^Qov, Re^Es, Xzg^Edb, Rb, Rb^Es, Re^Es, Rb, Xzg^Edb, Xzg, Xzg, Xzgg^Qov, Xzgg
Dd, Dd, Dd^Edp, Dd^Edp, Dd^Edp, Gd, Mdd, Dd^Edp, Mdd, Hhd^Ftd, Hhd^Ftd, Mdd, Hhd, Mdd, Mdd, Mdd, Dd^Edp, Dd^Ftd, Dd, Rd, Dd, Dd, Dd, Rd, Dd, Rd, Rd, Dd, Xzg3^Qov, Xzg3, Xzg2, Xzg2, Xzgg, Xzgg^Es, Xzgg, Xzgg^Qov, Xzg^Qov, Xzg, Re^Es, Xzg^Es, Re, Re, Xzg^Edb, Rb, Xzg, Re, Xzg^Es, Xzg^Es, Xzg^Edb, Xzg, Xzgg^Qov, Xzgg^Qov, Xzg2
Dd, Dd^Edp, Dd, Dd^Edp, Gd, Gd^Edp, Hhd, Mdd, Mdd, Hhd^Ftd, Hhd^Ftd, Hhd^Ftd, 3 Hhd^Ftd, Hhd^Ftd, Hhd^Ftd, Hhd^Edp, Dd^Edp, Rd, Re, Re, Dd^Edp, Dd^Edp, Dd, Dd, Dd, Rd, Dd, Dd, Xzg3^Qov, Xzg2, Xzg2^Es, Xzgg^Es, Xzgg, Xzgg, Xzg^Qov, Xzg^Qov, Xzg^Es, Xzg, Rb^Edb, Rb, Xzg, Xzg, Xzg, Xzg, Xzgg^Qov, Xzg, Xzg^Edb, Xzg^Edb, Xzg^Qov, Xzgg^Qov, Xzgg, Xzg2, Xzg2
Dd, Dd, Dd, Dd, Hhd^Ftd, Dd^Ftd, Hhd^Ftd, Mdd, Mdd, Mdd, Mdd, Hhd^Ftd, Dd^Ftd, Gd^Ftd, Gd^Ftd, Dd, Dd, Rd, Dd^Ftd, Dd, Dd^Ftd, Dd^Edp, Xzg3^Qov, Dd, Xzg3^Qov, Dd, Xzg3^Qov, Dd, Xzg3^Qov, Xzg3, Xzg2^Es, Xzg2, Xzgg, Xzgg^Qov, Xzg^Qov, Xzg, Rb, Rb^Es, Re^Edb, Re^Edb, Xzg, Xzgg^Qov, Xzgg^Qov, Xzgg^Qov, Xzgg, Xzgg^Qov, Xzgg^Qov, Xzgg^Qov, Xzgg^Es, Xzgg, Xzg2^Es, Xzg2^Es, Xzg2
Dd, Dd, Gd, Gd, Mdd, Hhd^Ftd, Hhd, Hhd^Ftd, Hhd^Ftd, Hhd, Hhd, Hhd, Gd, Gd, Rd, Dd, Dd^Ftd, Dd, Dd, Dd^Ftd, Xzg3^Qov, Xzg3^Qov, Xzg3, Xzg3^Qov, Xzg3^Qov, Xzg3^Qov, Xzg3, Xzg3^Qov, Xzg3, Xzg3^Es, Xzg2^Es, Xzg2, Xzgg^Qov, Xzg^Qov, Xzg^Edb, Xzg^Edb, Rb, Re^Es, Xzg, Xzg, Xzgg^Qov, Xzgg^Qov, Xzg2, Xzgg, Xzgg^Es, Xzgg, Xzg2, Xzg2, Xzgg, Xzgg, Xzg2, Xzg2^Es, Xzg3
Dd, Dd, Dd, Gd, Hhd^Ftd, Mdd, Mdd, Hhd^Ftd, Gd, Gd, Rd, Rd, Re, Re, Dd, Gd^Ftd, Dd^Edp, Dd^Vdt, Dd, Xzg3^Qov, Xzg3, Xzg3, Xzg2^Es, Xzg2, Xzg2, Xzg2, Xzg2, Xzg3, Xzg2, Xzg2^Es, Xzg2, Xzg2, Xzgg^Qov, Xzg, Xzg^Edb, Re, Rb, Xzg^Es, Xzg, Xzg, Xzg^Qov, Xzgg, Xzg2, Xzg2, Xzg2, Xzg2^Es, Xzg2, Xzg2, Xzg2, Xzg2, Xzg3, Xzg3, Xzg3
Dd, Dd, Dd, Hhd^Ftd, Hhd^Ftd, Mdd, Hhd, Dd^Vdt, Rd, Gd, Rd, Rd, Re, Gd, Gd^Edp, Gd^Ftd, Dd^Edp, Dd^Ftd, Dd, Xzg3^Qov, Xzg3, Xzg2, Xzg2^Es, Xzg2, Xzgg, Xzg2, Xzgg, Xzg2, Xzgg, Xzg2, Xzgg^Qov, Xzgg^Qov, Xzg^Qov, Xzg^Edb, Xzg^Edb, Xzg^Edb, Rd, Re^Es, Xzg, Xzg, Xzgg^Qov, Xzgg^Qov, Xzg2, Xzg2^Es, Xzg3, Xzg3^Es, Xzg3, Xzg3, Xzg3^Qov, Xzg3^Qov, Xzg3^Qov, Xzg3^Qov, Xzg3^Qov
Dd, Dd, Hhd, Hhd, Gd, Hhd, Rd, Rd, Gd^Edp, Rd, Dd, Hhd, Hhd, Hhd, Dd^Ftd, Dd^Edp, Dd^Edp, Dd^Ftd, Xzg3^Qov, Xzg3^Qov, Xzg2, Xzg2, Xzgg, Xzgg, Xzgg^Es, Xzgg, Xzg^Qov, Xzgg, Xzgg^Qov, Xzgg^Qov, Xzgg^Qov, Xzgg^Qov, Xzg^Qov, Xzg, Rd, Rd, Re^Es, Re^Es, Re^Es, Xzg, Xzgg^Qov, Xzg2, Xzg2, Xzg3, Xzg3, Xzg3^Es, Xzg3^Qov, Xzg3^Qov, Dd, Dd^Ftd, Dd^Ftd, Dd, Dd^Ftd
Dd, Dd, Dd, Gd, Rd, Gd, Gd^Ftd, Gd^Edp, Gd^Edp, Dd^Edp, Hhd, Hhd, Hhd^Edp, Dd^Ftd, Dd^Ftd, Dd, Xzg3^Qov, Xzg3^Qov, Xzg3, Xzg2, Xzg2^Es, Xzg2, Xzgg, Xzgg, Xzgg^Qov, Xzg^Qov, Xzg^Edb, Xzg^Qov, Xzg^Qov, Xzg^Qov, Xzg^Qov, Xzg^Qov, Rd, Rd, Xzg^Edb, Rd, Xzg^Es, Xzg^Es, Xzg, Xzg, Xzgg^Qov, Xzgg^Qov, Xzg2^Qov, Xzg2, Xzg3, Xzg3^Qov, Dd^Ftd, Dd^Ftd, Dd, Dd^Ftd, Dd, Dd^Ftd, Dd
Dd, Dd, Re, Rd, Dd, Gd^Ftd, Gd^Ftd, Gd^Ftd, Dd^Edp, Dd^Edp, Dd^Ftd, Gd^Edp, Gd^Ftd, Gd^Ftd, Dd^Ftd, Xzg3^Qov, Dd, Xzg3, Xzg2, Xzg2, Xzg2, Xzgg, Xzg^Qov, Xzg^Qov, Xzg^Qov, Xzg^Edb, Re, Xzg, Xzg, Xzg, Xzg, Xzg, Rd, Xzg^Edb, Xzg^Edb, Xzg^Edb, Xzg, Xzg, Xzgg^Qov, Xzgg^Qov, Xzgg^Qov, Xzg2^Qov, Xzg2, Xzg3, Xzg3, Xzg3^Qov, Dd^Ftd, Dd^Ftd, Dd^Es, Dd^Edp, Hhd, Hhd, Dd
Dd, Re, Re, Dd, Dd, Gd^Ftd, Dd, Dd^Ftd, Dd^Edp, Dd, Dd, Dd^Ftd, Dd^Ftd, Dd^Ftd, Xzg3^Qov, Xzg3^Qov, Xzg3, Xzg3, Xzg2, Xzg2, Xzg2, Xzgg^Qov, Xzg^Qov, Xzg, Xzg^Es, Xzg, Rb, Re^Es, Re^Edb, Xzg^Es, Re^Edb, Re^Es, Xzg^Edb, Xzg^Edb, Xzg^Edb, Xzg^Edb, Xzg, Xzgg^Qov, Xzg2^Qov, Xzg2^Qov, Xzg2^Es, Xzg2, Xzg2, Xzg2, Xzg2, Xzg3^Qov, Dd, Dd^Edp, Dd^Edp, Dd^Ftd, Hhd^Ftd, Mdd, Mdd
Rd, Re, Dd, Dd, Dd, Dd, Dd^Ftd, Dd, Dd, Dd, Xzg3^Qov, Xzg3^Qov, Xzg3^Qov, Xzg3^Qov, Xzg3, Xzg3, Xzg2, Xzg2, Xzgg, Xzgg, Xzgg, Xzgg^Qov, Xzg^Qov, Xzg^Es, Re, Rb, Xzg, Rb, Xzg, Re^Edb, Xzg^Es, Xzg, Xzg^Edb, Xzg^Edb, Xzg, Xzg, Xzgg^Qov, Xzg2^Qov, Xzg2, Xzg2, Xzg3^Qov, Xzg3, Xzg3^Qov, Xzg2, Xzg3, Xzg3^Qov, Xzg3^Qov, Dd^Edp, Dd^Edp, Hhd^Ftd, Hhd, Mdd, Mdd
Dd, Dd, Dd^Ftd, Hhd, Dd^Ftd, Dd, Dd, Dd^Ftd, Dd^Ftd, Xzg3^Qov, Xzg3^Es, Xzg3, Xzg2, Xzg2, Xzg2, Xzg2, Xzgg, Xzgg, Xzg^Qov, Xzgg, Xzg^Qov, Xzgg^Qov, Xzg^Qov, Xzg^Edb, Rb^Edb, Rb, Xzg, Xzg^Es, Xzg, Xzg^Es, Xzg, Xzg, Xzg, Xzg, Xzgg^Qov, Xzgg^Qov, Xzgg^Qov, Xzg2, Xzg3^Qov, Xzg3^Qov, Dd, Xzg3^Qov, Xzg3^Qov, Xzg3^Qov, Xzg3^Qov, Xzg3^Qov, Dd, Dd, Gd^Ftd, Dd^Ftd, Mdd, Mdd, Mdd
Dd, Dd, Dd, Hhd^Ftd, Hhd^Ftd, Dd^Ftd, Dd^Ftd, Dd^Ftd, Dd^Ftd, Xzg3^Qov, Xzg3, Xzg2, Xzg3, Xzg2^Es, Xzg2^Es, Xzgg, Xzg^Qov, Xzg^Qov, Xzg, Xzg^Qov, Xzg^Edb, Xzg^Qov, Xzg^Edb, Xzg^Edb, Re^Edb, Re, Xzg, Xzgg^Qov, Xzgg^Qov, Xzgg^Qov, Xzgg^Qov, Xzgg^Qov, Xzgg^Qov, Xzgg^Qov, Xzg2, Xzg2^Qov, Xzg2, Xzg2, Xzg3^Qov, Dd, 2 Rd, Dd, Dd, Dd, Dd^Edp, Dd, Dd^Ftd, Gd^Ftd, Hhd^Ftd, Hhd, Mdd, Mdd, Mdd
Dd, Hhd, Hhd, Hhd^Ftd, Hhd, Hhd^Ftd, Dd, Dd^Ftd, Dd, Xzg3^Qov, Xzg2, Xzg2, Xzg3, Xzg2, Xzgg, Xzgg, Xzg^Qov, Xzg^Edb, Xzg^Edb, Xzg^Edb, Re^Edb, Xzg^Edb, Xzg^Edb, Xzg^Edb, Xzg^Edb, Xzg, Xzg, Xzgg^Qov, Xzgg, Xzg2, Xzg2^Es, Xzg2, Xzg2, Xzg2, Xzg2^Es, Xzg2^Es, Xzg2, Xzg3, Xzg3^Qov, Dd, Dd, Rd, Re, Dd, Dd^Edp, Dd^Edp, Dd, Dd, Dd, Mdd, Mdd, Mdd, Mdd
Dd^Ftd, Dd, Dd^Ftd, Hhd^Ftd, Hhd, Dd^Ftd, Dd^Ftd, Dd^Ftd, Dd, Xzg3^Qov, Xzg3, Xzg2, Xzg2, Xzg2, Xzgg, Xzgg^Qov, Xzg^Qov, Xzg^Edb, Rb^Edb, Rb^Es, Xzg^Es, Xzg^Edb, Xzg, Xzg^Edb, Xzg, Xzg, Xzgg^Qov, Xzgg^Qov, Xzg2, Xzg2, Xzg2, Xzg2^Es, Xzg3^Qov, Xzg3^Qov, Xzg3^Qov, Xzg2, Xzg3^Qov, Xzg3, Xzg3^Qov, Xzg3^Qov, Dd, Re, Dd, Dd, Dd, Dd, Dd, Dd, Dd, Hhd, Hhd, Mdd, Mdd
Dd, Dd^Ftd, Dd^Ftd, Dd^Ftd, Dd, Dd, Xzg3^Qov, Dd, Xzg3^Qov, Xzg3^Qov, Xzg2^Es, Xzg2, Xzgg, Xzgg, Xzg^Qov, Xzg^Qov, Xzg, Rb, Xzg, Re^Es, Re, Re, Xzg^Edb, Xzg, Xzgg^Qov, Xzgg^Qov, Xzg2^Es, Xzg2, Xzg3, Xzg3, Xzg3^Qov, Xzg3, Xzg3^Qov, Dd^Ftd, Dd^Ftd, Xzg3^Qov, Dd, Xzg3^Qov, Xzg3^Qov, Dd, Dd^Ftd, Dd, Rd, Dd, Dd, Rd, Rd, Rd, Rd, Dd, Hhd^Ftd, Mdd, Mdd
Xzg3^Qov, Dd, Xzg3^Qov, Dd, Xzg3^Qov, Dd, Xzg3^Qov, Xzg3^Qov, Xzg3, Xzg3, Xzg2^Es, Xzg2^Es, Xzgg^Qov, Xzgg^Qov, Xzg, Xzg, Xzg^Edb, Re^Es, Rb, Xzg, Xzg, Xzg, Xzg^Edb, Xzg^Edb, Xzgg^Qov, Xzg2, Xzg2^Es, Xzg2, Xzg3^Qov, Xzg3^Qov, Xzg3^Qov, Xzg3^Qov, Xzg3^Qov, Xzg3^Qov, Dd^Ftd, Dd^Ftd, Gd^Ftd, Dd, Dd, Dd, Dd^Edp, Rd, Rd, Re, Re, Re, Re, Dd, Rd, Dd, Dd, Hhd^Ftd, Dd
Xzg3, Xzg3^Qov, Xzg3, Xzg3^Qov, Xzg2^Qov, Xzg3^Qov, Xzg2, Xzg2, Xzg2, Xzg2, Xzgg, Xzgg, Xzg^Qov, Xzg^Qov, Xzg^Edb, Xzg^Edb, Xzg^Edb, Rb^Es, Re, Xzg, Xzg, Xzgg^Qov, Xzgg^Qov, Xzgg^Qov, Xzg2^Es, Xzgg^Qov, Xzg2^Qov, Xzg3^Qov, Dd^Ftd, Dd, Dd^Ftd, Dd, Gd^Ftd, Dd^Edp, Dd^Edp, Gd^Ftd, Dd, Gd^Ftd, Dd, Dd, Dd^Edp, Dd^Edp, Dd, Rd, Re, Re, Re, Re, Dd, Dd, Dd^Es, Dd, Dd
Xzg2, Xzg3^Es, Xzg2^Es, Xzg2, Xzgg, Xzg2, Xzgg, Xzg2, Xzgg, Xzgg, Xzgg^Es, Xzgg, Xzgg^Qov, Xzg, Xzg^Edb, Xzg^Edb, Rb^Edb, Re, Xzg^Es, Xzg, Xzg^Es, Xzg^Qov, Xzgg^Qov, Xzg2, Xzg2^Es, Xzg2, Xzg2, Xzg3^Qov, Xzg3^Qov, Dd^Es, Gd^Ftd, Gd^Ftd, Gd^Edp, Gd^Edp, Dd^Edp, Dd^Edp, Dd, Rd, Rd, Rd, Dd, Dd, Re, Rd, Re, Dd, Dd, Re, Dd, Dd^Edp, Dd^Edp, Gd^Edp, Gd
Xzg2, Xzg2, Xzg2^Es, Xzg2, Xzgg, Xzgg, Xzgg, Xzgg, Xzgg, Xzgg^Es, Xzg^Qov, Xzgg^Qov, Xzg^Qov, Xzg^Es, Xzg, Re, Rb, Re, Re, Xzg, Xzg, Xzgg^Qov, Rd, Re, Re, Rd, Rd, Xzg2^Qov, Xzg3^Qov, Dd, Dd, Dd, Dd, Dd^Edp, Dd, Dd, Dd, Re, Dd, Dd, Dd, Re, Re, Rd, Rd, Dd, Dd, Rd, Rd, Dd, Dd, Gd^Edp, Gd
Xzgg, Xzgg, Xzgg, Xzgg, Xzgg^Qov, Xzg^Qov, Xzg^Qov, Xzg^Qov, Xzg^Qov, Xzg^Qov, Xzg, Xzg^Qov, Xzg^Es, Xzg, Xzg^Es, Xzg, Re, Xzg, Xzg, Re, Re, Rd, Xzgg, Xzg2, Xzg3, Xzg3^Es, Xzg3, Re, Re, Dd, Dd, Rd, Rd, Rd, Dd, Rd, Dd, Dd, Dd^Es, Dd, Dd^Edp, Dd, Dd, Dd, Dd, Rd, Rd, Dd, Rd, Dd, Dd^Edp, Dd^Edp, Gd
Xzg^Qov, Xzgg, Xzg^Qov, Xzg^Qov, Xzg^Qov, Xzg, Xzg, Xzg^Edb, Re, Xzg, Rb, Re^Es, Rb, Re, Re, Re, Xzg, Xzg, Xzgg^Qov, Xzg, Xzgg, Xzgg, Xzg2^Qov, Xzg2^Qov, Xzg2^Qov, Xzg3, Xzg3^Qov, Dd, Dd, Rd, Dd, Dd, Dd, Dd^Edp, Dd^Edp, Dd, Dd, Dd, Dd^Es, Dd, Hhd^Edp, Dd^Edp, Dd, Dd^Es, Rd, Re, Dd, Re, Dd, Dd, Dd, Gd^Edp, Dd
Xzg, Xzg^Qov, Xzg, Xzg, Xzg, Xzg^Es, Xzg^Edb, Re^Edb, Xzg^Edb, Rb^Edb, Rb^Edb, Xzg^Es, Xzg, Xzg, Xzg^Es, Xzg, Xzg^Edb, Xzgg^Qov, Xzg2^Qov, Xzgg^Qov, Xzgg^Qov, Xzg2^Qov, Xzg3, Xzg2, Xzg3^Qov, Xzg3^Qov, Dd^Ftd, Dd, Dd^Edp, Dd, Dd^Edp, Dd, Dd^Ftd, Dd, Dd, Dd^Ftd, Hhd^Ftd, Dd^Ftd, Gd^Ftd, Hhd^Ftd, Mdd, Hhd, Hhd, Dd, Dd, Re, Re, Dd, Dd, Dd, Dd, Dd^Es, Dd
Xzg, Re, Rb^Es, Rb^Edb, Rb^Edb, Re^Edb, Re^Es, Re, Re, Rb, Xzg, Xzg, Xzgg^Qov, Xzg^Edb, Xzgg^Qov, Xzg^Edb, Xzgg^Qov, Xzgg^Qov, Xzg2, Xzg2^Es, Xzg2, Xzg2, Xzg3^Qov, Xzg3^Qov, Dd, Dd, Gd^Ftd, Gd^Ftd, Hhd^Edp, Hhd^Edp, Hhd^Ftd, Dd^Ftd, Mdd, Hhd^Ftd, Mdd, Mdd, Mdd, Hhd^Ftd, Mdd, Hhd^Ftd, Mdd, Mdd, Mdd, Dd, Dd^Edp, Rd, Re, Re, Rd, Rd, Dd, Dd^Es, Dd
Re, Rb^Edb, Rb, Xzg, Xzg, Xzg^Es, Xzg, Xzg, Xzg, Xzg, Xzgg^Qov, Xzgg^Qov, Xzg2, Xzgg^Qov, Xzg2, Xzgg^Qov, Xzg2, Xzg2, Xzg3^Es, Xzg3, Xzg3^Es, Xzg3, Xzg3^Qov, Dd^Ftd, Dd^Es, Dd^Ftd, Gd^Ftd, Gd^Edp, Gd^Edp, Dd^Ftd, Gd^Ftd, Hhd, Mdd, Mdd, Mdd, Mdd, Mdd, Mdd, Mdd, Mdd, Mdd, Mdd, Mdd, Hhd^Edp, Dd^Edp, Dd, Dd, Dd, Dd, Re, Dd, Dd, Dd
Re, Re^Edb, Re, Xzg, Xzgg^Qov, Xzgg^Qov, Xzgg^Qov, Xzgg^Qov, Xzgg^Qov, Xzgg^Qov, Xzg2, Xzg2, Xzg3, Xzg2, Xzg3^Es, Xzg2, Xzg3, Xzg3, Xzg3, Xzg2, Xzg3, Xzg3^Qov, Dd, Dd, Dd, Dd^Ftd, Dd^Ftd, Gd^Ftd, Dd^Ftd, Gd^Ftd, Dd, Dd^Ftd, Dd^Ftd, Hhd, Hhd, Hhd, Hhd, Mdd, Mdd, Mdd, Mdd, Mdd, Mdd, Hhd^Edp, Mdd, Hhd^Edp, Dd, Dd^Edp, Dd, Re, Re, Dd, Rd
Xzg, Xzg, Xzg, Xzg^Qov, Xzgg, Xzgg^Qov, Xzg2, Xzg2, Xzg2, Xzg2, Xzg2, Xzg2, Xzg2, Xzg3^Es, Xzg2, Xzg2, Xzg2, Xzg2, Xzg2, Xzg3, Xzg3, Xzg3^Qov, Xzg3, Dd^Ftd, Dd, Dd^Ftd, Dd, Dd, Dd, Dd, Dd, Dd, Dd, Dd, Dd, Dd^Ftd, Dd, Mdd, Dd, Mdd, Mdd, Mdd, Mdd, Mdd, Mdd, Mdd, Dd, Dd, Dd, Rd, Dd, Re, Dd
