Wot, Wot, Wot, Wot, Wot, Wot, Wot, Wot, Wot, Wot, Ww, Wot, Ww, Ww, Ww, Ds, Ds, Ds, Ds, Xzgg, Xzgg^Qov, Xzgg, Ds, Ds, Ds, Xzg2, Xzg2^Qov, Xzg2^Qov, Xzg3, Xzg3, Xzg3, Xzg3, Xzg3^Qov, Xzg3^Qov, Dd, Dd^Edp, Dd, Dd, Dd, Dd, Dd, Dd, Dd, Dd, Dd, Dd, Dd, Dd, Dd, Dd, Dd, Dd, Dd, Dd, Dd, Dd, Dd
Wot, Wot, Wot, Wot, Wot, Wot, Wot, Wot, Wot, Wot, Ww, Wot, Ww, Ww, Wwf, Ds, Ds^Edp, Ds^Edp, Xzgg, Xzgg, Xzgg^Qov, Xzg2, Xzg2, Rd, Rd, Xzg2^Qov, Xzg3, Xzg3, Xzg3, Xzg3, Xzg3, Xzg3^Qov, Dd, Dd, Dd^Edp, Dd^Edp, Dd, Dd, Dd^Vdt, Dd, Dd, Dd, Dd, Dd, Dd, Dd, Dd^Edp, Dd, Dd^Edp, Dd, Dd^Edp, Dd^Edp, Dd, Dd, Dd, Dd, Dd
Wot, Wot, Wot, Wot, Wot, Wot, Wwrt, Wwrt, Wot, Wwrt, Ww, Wot, Ww, Ww, Wwf, Ds^Es, Ds^Es, Ds, Xzgg, Xzgg, Xzgg^Qov, Xzg2, Rd, 1 Rd, Xzg2, Xzg2^Qov, Xzg3^Edp, Xzg3^Edp, Xzg3^Edp, Xzg3, Xzg3^Qov, Xzg3^Qov, Dd, Dd, Rd, Dd, Re, Dd, Re, Re, Re, Rd^Vdt, Rd, Dd, Dd, Dd^Edp, Dd, Dd, Dd^Edp, Dd^Edp, Dd^Edp, Dd, Dd, Dd, Dd, Dd, Dd
Wot, Wot, Wot, Wot, Wot, Wot, Wwrt, Wwrt, Wwrt, Wwrt, Ww, Ww, Ww, Wwf, Wwf, Ds, Ds^Es, Ds^Es, Rd, Xzgg, Xzg2, Xzg2, Xzg2, Rd, Xzg2, Xzg2^Qov, Xzg3, Xzg3^Edp, Xzg3, Xzg3^Qov, Dd^Edp, Dd, Dd, Rd, Dd^Vdt, Re, Re, Rd^Ecf, Re, Rd, Re, Rd, Rd^Ecf, Rd, Dd, Dd, Dd, Dd^Edp, Dd^Rusy, Dd^Edp, Dd^Edp, Dd^Es, Dd^Edp, Dd^Rusy, Dd, Dd, Dd
Wot, Wot, Wot, Wot, Wot, Wwrt, Wot, Wot, Wwrt, Wwrt, Ww, Ww, Wwf, Wwf, Ds^Es, Ds^Es, Xzgg, Xzgg, Re, Re, Re, Xzg2, Rd, Xzg2, Xzg2^Qov, Xzg2^Qov, Xzg3, Xzg3^Edp, Xzg3, Xzg3^Qov, Dd, Dd^Edp, Dd^Edp, Dd, Dd, Re, Rd, Re, Rd, Dd, Rd^Vdt, Re, Rd, Dd, Dd, Dd, Dd^Es, Dd^Es, Dd, Dd, Dd^Rusy, Dd^Edp, Dd^Edp, Dd^Edp, Dd^Es, Dd, Dd
Wot, Wot, Wot, Wot, Wwrt, Wot, Wot, Wot, Ww, Ww, Ww, Ww, Ds, Ds, Xzgg, Ds, Xzgg, Rd, Xzgg^Qov, Xzg2, Rd, Rd, Xzg2^Qov, Xzg2^Qov, Xzg3, Xzg3, Xzg3^Edp, Xzg3, Xzg3^Edp, Xzg3^Qov, Xzg3^Qov, Dd^Edp, Xzg3^Qov, Dd, Dd, Dd, Dd, Dd, Dd, Dd, Dd, Dd, Dd, Dd^Vdt, Dd, Dd, Dd^Es, Dd^Es, Dd^Edp, Dd^Edp, Dd, Dd^Edp, Dd^Edp, Dd, Dd^Es, Dd, Dd
Wot, Wot, Wot, Wot, Wwrt, Wwrt, Wwrt, Wwrt, Ww, Ww, Ww, Ds, Ds, Ds, Xzgg, Xzgg, Xzgg^Edp, Xzgg^Qov, Xzg2, Xzg2, Rd, Xzg2, Xzg2^Qov, Xzg3, Xzg3, Xzg3, Xzg3, Xzg3, Xzg3, Xzg3^Edp, Xzg3, Xzg3^Qov, Xzg3^Edp, Xzg3^Qov, Xzg3^Qov, Xzg3^Qov, Xzg3^Qov, Dd, Xzg3^Qov, Dd, Dd, Dd, Dd^Edp, Dd, Dd, Dd, Rd, Dd, Dd, Dd, Dd, Dd^Edp, Dd, Dd^Edp, Dd, Dd^Edp, Dd
Wot, Wot, Wot, Wot, Wot, Ww, Ww, Ww, Ww, Ww, Ww, Ds, Ds, Xzgg^Edp, Xzgg^Edp, Xzgg^Edp, Xzgg^Edp, Xzgg^Qov, Xzg2, Rd, Rd, Xzg2, Xzg2^Qov, Xzg3, Rd, Xzg3, Rd, Xzg3, Xzg3, Xzg3, Xzg3, Xzg3, Rd, Xzg3^Edp, Xzg3^Edp, Xzg3^Edp, Xzg3, Xzg3^Qov, Xzg3, Xzg3^Qov, Xzg3^Qov, Xzg3^Qov, Dd^Edp, Dd^Edp, Dd^Edp, Dd, Rd, Rd, Dd, Dd, Dd, Dd, Dd^Edp, Dd^Edp, Dd^Edp, Dd^Rusy, Dd
Wot, Wot, Wot, Wot, Ww, Ww, Wot, Ww, Ww, Ww, Ds, Ds, Ds, Xzgg, Ds^Edp, Xzgg^Edp, Xzgg, Xzgg^Qov, Xzg2, Xzg2, Xzg2, Xzg2, Xzg2, Re, Re, Rd, Rd, Xzg3, Xzg3, Xzg3, Xzg3, Xzg3, Rd, Rd, Re, Rd, Rd^Vdt, Xzg3, Rd, Xzg3, Xzg3, Xzg3^Qov, Dd^Edp, Dd^Edp, Dd^Edp, Dd, Dd, Dd, Rd, Dd, Dd, Dd, Dd, Dd^Edp, Dd, Dd, Dd
Wot, Wot, Wot, Wot, Wot, Wot, Wwrt, Ww, Ww, Ww, Ww, Ds, Ds, Ds, Ds, Xzgg^Edp, Xzgg, Xzgg^Qov, Xzgg^Qov, Xzg2^Es, Xzg2, Xzg2, Rd, Re, Xzg2, Xzg3, Xzg3, Xzg3, Xzg3, Xzg3^Edp, Xzg3, Xzg3^Vdt, Xzg3, Rd, Re, Re, Rd, Xzg3, Xzg3, Rd, Xzg3^Qov, Xzg3^Qov, Xzg3^Qov, Dd, Dd^Edp, Dd^Edp, Dd, Dd, Rd, Dd, Dd, Dd, Dd, Dd, Dd, Dd, Dd
Wot, Wot, Wot, Wot, Wot, Wot, Wwrt, Ww, Ww, Ww, Wwf, Wwf, Ds, Ds, Ds^Es, Xzgg, Xzgg, Xzgg, Xzgg, Xzgg^Qov, Xzgg^Qov, Xzg2, Xzg2, Xzg2, Xzg2, Xzg2^Qov, Xzg2^Qov, Xzg2^Qov, Xzg2^Qov, Xzg3, Xzg2^Qov, Xzg3, Rd, Re, Re, Rd^Ecf, Rd, Rd, Xzg3, Xzg3, Xzg3^Qov, Dd, Dd, Dd, Dd^Edp, Dd^Edp, Dd, Rd, Dd, Dd, Dd, Dd, Dd, Dd^Edp, Dd, Dd, Dd
Wot, Wot, Wot, Wot, Wot, Wot, Ww, Wwrt, Wot, Ww, Ww, Wwf, Wwf, Ds^Es, Ds^Es, Ds, Ds, Xzgg, Xzgg^Edp, Xzgg, Xzgg^Qov, Xzg2, Xzg2, Xzg2, Rd, Xzg2, Rd, Xzg2, Xzg2^Edp, Xzg2^Qov, Xzg2^Qov, Xzg3, Xzg3, Xzg3^Vdt, Rd, Re, Rd, Xzg3^Vdt, Xzg3^Edp, Xzg3, Xzg3^Qov, Dd, Dd, Dd^Edp, Dd^Edp, Dd, Dd, Rd, Rd, Dd, Dd, Dd^Edp, Dd^Edp, Dd^Edp, Dd^Edp, Dd, Dd
Wot, Wot, Wot, Wot, Wot, Wot, Ww, Wwrt, Wwrt, Ww, Ww, Wwf, Wwf, Ds, Ds^Es, Ds, Xzgg^Edp, Xzgg^Edp, Xzgg, Xzgg, Xzgg, Xzgg^Qov, Xzgg^Qov, Xzg2^Edp, Xzg2^Edp, Rd, Re, Rd^Edp, Xzg2^Edp, Xzg2, Xzg2^Qov, Xzg2^Qov, Xzg3, Xzg3, Xzg3, Rd, Xzg3, Xzg3^Edp, Xzg3^Edp, Xzg3^Qov, Dd, Dd, Dd, Dd, Dd, Dd, Dd, Dd, Rd, Dd, Dd, Dd, Dd, Dd^Edp, Dd^Es, Dd, Dd
Wot, Wot, Wot, Wot, Wot, Wot, Wot, Ww, Ww, Wot, Ww, Ww, Wwf, Wwf, Ds, Ds^Es, Xzgg, Xzgg, Xzgg, Xzgg, Xzgg^Edp, Xzgg^Edp, Xzgg^Qov, Xzg2^Edp, Xzg2^Edp, Xzg2^Edp, Rd, Re, Xzg2^Qov, Xzg2^Qov, Xzg3^Edp, Xzg2^Qov, Xzg3^Edp, Xzg3^Edp, Xzg3, Xzg3, Xzg3^Edp, Xzg3^Edp, Xzg3^Qov, Xzg3^Qov, Dd, Dd, Rd, Rd, Rd, Rd, Dd, Dd, Dd, Dd, Dd^Rusy, Dd, Dd, Dd^Edp, Dd, Dd^Es, Dd
Wot, Wot, Wot, Wot, Wot, Wot, Wot, Wot, Wot, Wot, Wot, Ww, Ww, Ww, Ds^Es, Ds, Ds, Xzgg, Rd, Xzgg, Xzgg^Vdt, Xzgg, Xzgg, Xzgg^Qov, Xzgg^Qov, Xzg2, Xzg2, Xzg2, Xzg2^Qov, Xzg3^Edp, Xzg3, Xzg3^Edp, Xzg3, Xzg3^Edp, Xzg3, Xzg3, Xzg3^Qov, Xzg3^Qov, Dd, Dd, Dd, Dd, Rd, Rd, Dd, Dd, Dd, Dd^Rusy, Dd^Rusy, Dd^Rusy, Dd^Rusy, Dd^Rusy, Dd, Dd, Dd, Dd, Dd
Wot, Wot, Wot, Wot, Wot, Wot, Wot, Wot, Wot, Ww, Ww, Ww, Ww, Ww, Ds^Es, Ds^Es, Ds^Edp, Rd, Rd^Ecf, Re, Re, Xzgg, Xzgg, Xzgg, Xzgg^Qov, Xzg2, Xzg2, Xzg2, Xzg2, Xzg2^Qov, Xzg3, Xzg3, Xzg3, Xzg3, Xzg3, Xzg3, Xzg3^Qov, Dd, Dd, Rd, Rd, Dd, Dd, Dd, Dd, Dd, Dd, Dd^Rusy, Dd^Rusy, Dd^Rusy, Dd^Rusy, Dd^Rusy, Dd^Edp, Dd, Dd, Dd, Dd
Wot, Wot, Wot, Wot, Wot, Wot, Wot, Wot, Ww, Ww, Wwf, Wwf, Wwf, Ds, Ds, Ds, Xzgg^Vdt, Xzgg, Re, Re, Rd^Vdt, Re, Xzgg, Xzgg, Xzgg, Xzgg^Qov, Xzg2, Xzg2, Rd, Rd, Rd, Rd, Rd, Rd, Xzg3, Xzg3, Xzg3^Qov, Dd, Dd, Re, Xzg3, Dd, Xzg3^Qov, Dd, Dd, Dd, Dd, Dd, Dd, Dd, Dd^Rusy, Dd^Rusy, Dd^Edp, Dd^Edp, Dd, Dd, Dd
Wot, Wot, Wot, Wot, Wot, Wot, Wot, Wwrt, Wwrt, Ww, Ww, Wwf, Ds, Ds, Xzgg^Es, Xzgg, Xzgg, Re, Rd, Re, Re, Re, Re, Xzgg, Xzgg^Qov, Xzgg^Qov, Xzg2^Edp, Xzg2, Xzg2, Rd, Xzg3, Xzg3, Xzg3, Rd, Rd, Xzg3, Xzg3, Xzg3^Qov, Rd, Re, Re, Xzg3^Qov, Xzg3, Xzg3^Qov, Dd, Dd, Dd^Edp, Dd^Edp, Dd^Edp, Dd^Edp, Dd^Es, Dd^Es, Dd, Dd^Edp, Dd, Dd, Dd
Wot, Wot, Wot, Wot, Wot, Wot, Wot, Wwrt, Wwrt, Ww, Ww, Wwf, Wwf, Ds^Es, Ds^Es, Xzgg, Xzgg, Xzgg, Xzgg^Vdt, Rd, Re, Re, Xzgg^Vdt, Xzgg, Xzgg^Qov, Xzg2^Edp, Xzg2^Edp, Xzg2, Xzg2, Xzg2, Xzg2^Qov, Xzg3, Xzg3, Xzg3, Xzg3, Rd, Xzg3, Xzg3, Rd, Rd, Xzg3, Xzg3, Xzg3, Xzg3^Qov, Dd, Dd, Dd, Dd^Edp, Dd^Edp, Dd, Dd^Edp, Dd^Edp, Dd^Edp, Dd^Edp, Dd^Edp, Dd, Dd
Wot, Wot, Wot, Wot, Wot, Wot, Wot, Wwrt, Wwrt, Wot, Ww, Wwf, Wwf, Ds, Ds^Es, Ds, Xzgg, Rd, Rd, Rd, Rd, Xzgg, Xzgg, Xzgg, Xzgg^Qov, Xzg2^Edp, Xzg2, Xzg2, Xzg2^Edp, Xzg2^Edp, Xzg2^Qov, Xzg3, Xzg3^Edp, Xzg3^Edp, Xzg3, Xzg3, Xzg3, Rd, Xzg3, Xzg3, Xzg3^Edp, Xzg3, Xzg3, Xzg3^Qov, Dd^Edp, Dd, Dd, Dd, Dd^Edp, Dd, Dd, Dd^Edp, Dd, Dd^Edp, Dd^Edp, Dd, Dd
Wot, Wot, Wwrt, Wot, Wot, Wot, Wot, Ww, Ww, Ww, Wot, Ww, Ds, Ds, Ds, Ds^Edp, Xzgg^Edp, Xzgg, Xzgg^Edp, Xzgg, Xzgg, Xzgg, Xzgg^Qov, Xzgg^Qov, Xzg2, Xzg2, Xzg2, Xzg2, Xzg2^Qov, Xzg2^Qov, Xzg3, Xzg3, Xzg3^Edp, Xzg3^Edp, Xzg3^Edp, Xzg3, Xzg3, Xzg3, Xzg3, Xzg3^Edp, Xzg3^Edp, Xzg3, Xzg3^Qov, Xzg3^Qov, Dd, Dd^Edp, Dd, Dd, Dd, Dd, Dd^Edp, Dd^Es, Dd^Edp, Dd^Edp, Dd^Es, Dd, Dd
Wot, Wwrt, Wot, Wot, Ww, Ww, Ww, Ww, Ww, Ww, Ds, Ds, Ds, Ds, Xzgg, Xzgg, Xzgg, Xzgg^Edp, Xzgg, Xzgg, Xzgg, Xzgg, Xzgg, Xzg2, Rd, Xzg2, Xzg2, Xzg2^Qov, Xzg3, Xzg3, Xzg3^Edp, Xzg3^Es, Xzg3^Edp, Xzg3^Edp, Xzg3, Xzg3, Xzg3^Es, Xzg3, Xzg3, Xzg3^Edp, Xzg3, Xzg3^Qov, Dd^Edp, Dd^Edp, Dd, Dd, Dd, Dd, Dd, Dd, Dd, Dd^Edp, Dd^Edp, Dd^Edp, Dd^Edp, Dd, Dd
Wot, Wwrt, Wwrt, Wwrt, Wot, Wot, Ww, Ww, Ww, Ww, Ds^Es, Ds^Es, Ds^Es, Xzgg^Es, Rd, Rd, Rd, Xzgg, Xzgg, Xzgg, Re, Re, Re, Rd, Xzg2, Xzg2, Xzg2, Xzg2^Qov, Xzg3, Xzg3, Xzg3^Edp, Xzg3^Edp, Xzg3^Edp, Xzg3^Edp, Xzg3^Edp, Xzg3^Edp, Xzg3, Xzg3^Es, Xzg3^Qov, Xzg3^Qov, Xzg3^Qov, Xzg3^Qov, Dd^Edp, Dd, Dd^Edp, Dd, Dd, Dd, Dd, Dd, Dd, Dd, Dd, Dd^Edp, Dd, Dd, Dd
Wot, Wot, Wwrt, Wwrt, Wot, Wot, Ww, Ww, Ww, Ds, Ds, Ds^Es, Xzgg, Rd, Re, Re, Xzgg, Xzgg, Xzgg, Rd, Xzgg^Qov, Re, Xzg2, Rd, Xzg2, Xzg2, Xzg2^Edp, Xzg2^Qov, Xzg3, Xzg3, Xzg3, Xzg3^Edp, Xzg3, Xzg3, Xzg3^Edp, Xzg3, Xzg3, Xzg3, Xzg3^Qov, Dd, Dd^Edp, Dd, Dd^Edp, Dd^Edp, Dd^Edp, Dd^Es, Dd^Edp, Dd, Dd, Dd, Dd, Dd, Dd, Dd, Dd^Edp, Dd^Edp, Dd
Wot, Wot, Wwrt, Wot, Ww, Ww, Ww, Ww, Ww, Ds, Ds^Es, Xzgg^Es, Xzgg^Es, Rd, Rd, Re, Xzgg, Xzgg, Xzgg, Xzgg^Qov, Xzg2, Xzg2, Xzg2, Xzg2, Xzg2, Xzg2, Xzg2, Xzg2^Qov, Xzg2^Qov, Xzg3^Edp, Xzg3, Xzg3, Xzg2^Qov, Xzg3, Xzg3, Xzg3, Xzg3, Xzg3, Xzg3^Qov, Dd, Dd, Dd^Edp, Dd^Edp, Dd^Edp, Dd, Dd, Dd, Dd, Rd, Dd^Vdt, Dd, Dd, Dd, Dd, Dd, Dd^Edp, Dd
Wot, Wot, Wot, Ww, Ww, Ww, Ww, Ww, Ww, Ds, Ds, Ds^Edp, Ds, Xzgg^Es, Xzgg^Es, Xzgg, Xzgg, Xzgg, Xzgg, Xzgg^Qov, Xzg2, Xzg2^Edp, Xzg2, Xzg2, Xzg2, Rd, Rd, Xzg2, Xzg2^Edp, Xzg2^Qov, Xzg2^Qov, Xzg2^Qov, Xzg2^Edp, Xzg2^Qov, Xzg2^Qov, Xzg3, Xzg3^Edp, Xzg3, Xzg3, Xzg3^Qov, Dd, Dd^Edp, Dd^Edp, Dd^Edp, Dd, Dd, Dd, Rd, Re, Rd, Rd, Rd, Dd, Dd, Dd^Edp, Dd^Es, Dd
Wot, Wot, Wot, Wot, Wot, Wot, Wot, Ww, Ww, Ds, Ds, Ds, Xzgg, Xzgg, Ds^Edp, Xzgg^Edp, Xzgg^Edp, Xzgg, Xzgg^Qov, Xzgg^Qov, Xzg2, Xzg2^Rusy, Xzg2^Rusy, Xzg2, Rd, Rd, Rd^Vdt, Xzg2, Rd, Xzg2, Xzg2, Xzg2, Xzg2^Edp, Xzg2, Xzg2^Qov, Xzg3^Edp, Xzg3^Edp, Xzg3, Xzg3, Xzg3^Qov, Xzg3^Qov, Dd, Dd, Dd, Dd, Dd, Dd^Vdt, Dd, Re, Re, Rd, Dd, Dd^Vdt, Dd, Dd, Dd^Edp, Dd
Wot, Wot, Wot, Wot, Wot, Wot, Ww, Ww, Ww, Ww, Ds, Ds, Ds, Ds, Ds, Xzgg, Xzgg^Edp, Xzgg, Xzgg^Qov, Xzg2, Xzg2^Rusy, Xzg2^Rusy, Xzg2, Xzg2, Rd^Vdt, Rd, Rd, Re, Re, Rd^Vdt, Rd, Rd, Xzg2, Xzg2^Edp, Xzg2^Qov, Xzg3^Edp, Xzg3, Xzg3^Edp, Xzg3, Xzg3^Qov, Dd, Dd, Dd^Edp, Dd, Dd, Dd, Dd, Re, Re, Rd^Ecf, Dd, Dd, Dd, Dd, Dd, Dd^Edp, Dd^Edp
Wot, Wot, Wot, Wot, Wot, Ww, Wot, Ww, Ww, Ww, Ds, Ds, Wwf, Ds, Ds, Ds, Ds^Edp, Xzgg, Xzgg^Qov, Xzg2, Xzg2^Edp, Xzg2^Rusy, Xzg2^Rusy, Xzg2, Xzg2, Xzg2, Xzg2, Rd^Ecf, Re, 2 Re, Re, Re, Rd, Xzg2, Xzg2, Xzg2^Qov, Xzg3, Xzg3, Xzg3, Xzg3^Qov, Dd, Dd^Edp, Dd^Edp, Dd^Edp, Dd, Dd, Rd, Rd, Re, Re, Re, Dd^Vdt, Dd, Dd, Dd^Edp, Dd^Edp, Dd
Wot, Wot, Wot, Wot, Wot, Wot, Wot, Ww, Ww, Ww, Ww, Wwf, Wwf, Ds, Ds, Ds^Edp, Ds^Edp, Ds, Xzgg^Qov, Xzg2, Xzg2, Xzg2^Rusy, Xzg2^Rusy, Xzg2^Rusy, Xzg2, Rd, Rd^Vdt, Re, Re, Re, Rd, Rd^Vdt, Rd, Xzg2, Xzg2^Qov, Xzg2^Qov, Xzg3, Xzg3^Es, Xzg3^Es, Xzg3^Qov, Dd, Dd, Dd^Edp, Dd, Dd^Es, Dd, Dd, Dd, Rd, Re, Rd, Dd, Dd, Dd^Edp, Dd^Edp, Dd^Edp, Dd^Edp
Wot, 3 Wot, Wot, Wot, Wot, Wot, Wot, Ww, Ww, Ww, Ww, Ww, Wwf, Wwf, Ds, Ds, Ds, Xzgg, Xzgg, Xzgg^Qov, Xzg2, Xzg2, Xzg2^Edp, Xzg2, Rd, Re, Re, Re, Rd, Xzg2^Vdt, Xzg2, Rd, Xzg2, Xzg2, Xzg2^Qov, Xzg3^Edp, Xzg3^Edp, Xzg3^Es, Xzg3, Xzg3^Qov, Xzg3^Qov, Dd, Dd, Dd, Dd, Dd, Dd, Dd^Vdt, Dd, Dd, Dd, Dd, Dd, Dd, Dd^Edp, Dd^Edp, Dd^Edp
Wot, Wot, Wot, Wot, Wot, Wot, Wot, Ww, Wot, Ww, Wot, Ww, Ww, Wwf, Wwf, Ds, Ds^Es, Xzgg, Xzgg, Xzgg^Qov, Xzg2, Xzg2^Edp, Xzg2, Xzg2, Rd, Rd, Xzg2, Rd, Xzg2^Qov, Xzg2^Qov, Xzg2^Qov, Xzg2^Qov, Xzg2^Qov, Xzg2^Qov, Xzg3, Xzg3, Rd, Xzg3^Es, Xzg3, Xzg3^Vdt, Xzg3, Xzg3^Qov, Xzg3^Qov, Dd, Dd, Dd, Dd, Dd, Dd, Dd, Dd, Dd, Dd^Es, Dd^Rusy, Dd^Edp, Dd^Edp, Dd
Wot, Wot, Wot, Wot, Wot, Wot, Wot, Wot, Wot, Ww, Wot, Ww, Ww, Wwf, Ds^Es, Ds, Ds^Es, Ds, Xzgg, Xzgg^Qov, Xzgg^Qov, Xzg2, Xzg2, Xzg2, Xzg2, Xzg2, Xzg2^Qov, Xzg2^Qov, Xzg3^Edp, Xzg3^Edp, Xzg3, Xzg3, Xzg3, Xzg3, Xzg3, Xzg3, Rd^Vdt, Rd, Rd, Rd, Rd, Xzg3, Xzg3, Xzg3^Qov, Xzg3^Qov, Xzg3^Qov, Dd^Edp, Dd^Edp, Dd^Edp, Dd, Dd, Dd, Dd^Edp, Dd^Edp, Dd^Edp, Dd^Edp, Dd
Wot, Wot, Wot, Wot, Wot, Wot, Wot, Wot, Wot, Wot, Wot, Ww, Ww, Wwf, Wwf, Ds, Ds^Es, Xzgg, Re, Rd, Xzgg, Rd, Rd, Xzg2, Xzg2, Xzg2, Xzg2^Qov, Xzg3, Xzg3^Es, Xzg3, Rd, Xzg3, Rd, Xzg3, Xzg3, Xzg3, Xzg3, Rd, Xzg3, Rd^Ecf, Rd, Xzg3, Xzg3^Vdt, Xzg3, Xzg3, Xzg3^Qov, Xzg3^Qov, Dd^Edp, Dd^Edp, Dd, Dd, Dd, Dd, Dd^Edp, Dd^Edp, Dd^Edp, Dd^Edp
Wot, Wot, Wot, Wot, Wot, Wot, Wot, Wot, Wot, Ww, Wot, Ww, Ww, Ww, Ww, Ds, Ds^Es, Xzgg, Xzgg, Re, Re, Rd, Rd, Xzg2, Xzg2^Edp, Xzg2, Xzg2^Qov, Xzg2^Qov, Xzg3^Edp, Xzg3, Xzg3, Rd, Rd, Rd, Rd, Rd, Xzg3, Xzg3, Xzg3^Edp, Rd, Xzg3, Re, Xzg3^Edp, Xzg3^Edp, Xzg3, Xzg3^Qov, Dd, Dd^Edp, Dd^Edp, Dd^Edp, Dd, Dd, Dd, Dd, Dd^Rusy, Dd^Edp, Dd
Wot, Wot, Wot, Wot, Wot, Wot, Wot, Wot, Wwrt, Wwrt, Ww, Ww, Ww, Ww, Ww, Ds, Xzgg, Xzgg, Xzgg^Qov, Xzg2, Xzg2, Xzg2, Xzg2, Xzg2, Xzg2, Xzg2, Xzg2^Qov, Xzg3, Xzg3^Edp, Xzg3^Es, Xzg3, Xzg3, Xzg3, Re, Re, Xzg3, Xzg2^Qov, Xzg3, Xzg3, Xzg3^Edp, Xzg3, Re, Xzg3, Xzg3, Xzg3^Edp, Xzg3^Qov, Dd, Dd^Edp, Dd, Dd^Rusy, Dd, Dd, Dd, Dd, Dd, Dd^Edp, Dd
Wot, Wot, Wot, Wot, Wwrt, Wot, Wot, Wot, Wot, Wot, Ww, Ww, Ww, Ww, Ds, Ds, Ds, Xzgg, Xzgg^Qov, Xzg2, Xzg2^Edp, Xzg2^Edp, Xzg2^Edp, Xzg2, Xzg2, Xzg2^Edp, Xzg2^Qov, Xzg3^Edp, Xzg3^Edp, Xzg3^Edp, Xzg3^Edp, Xzg2^Qov, Xzg2, Re, Re, Rd, Xzg2, Xzg2^Qov, Xzg3, Xzg3^Edp, Xzg3, Re, Rd, Xzg3^Edp, Xzg3, Xzg3^Qov, Dd, Dd, Dd, Dd, Dd, Dd, Dd, Dd, Dd, Dd, Dd
Wot, Wot, Wot, Wwrt, Wwrt, Wwrt, Ww, Wot, Ww, Ww, Ww, Ww, Wwf, Ds, Ds^Es, Ds, Ds^Edp, Xzgg, Xzgg^Qov, Xzg2, Xzg2, Xzg2^Edp, Xzg2^Edp, Xzg2, Xzg2, Xzg2, Xzg2, Xzg2^Qov, Xzg2^Qov, Xzg3^Edp, Xzg2^Qov, Xzg2^Qov, Xzg2, Xzg2, Re, Xzg2, Xzg2, Xzg2^Qov, Xzg2^Qov, Xzg3, Xzg3^Es, Xzg3, Xzg3, Xzg3, Xzg3, Xzg3^Qov, Xzg3^Qov, Dd, Dd, Rd, Rd, Dd, Dd, Dd, Dd, Dd, Dd
Wot, Wot, Wot, Wwrt, Wwrt, Wot, Wot, Ww, Wot, Ww, Ww, Ww, Wwf, Ds, Ds, Ds^Edp, Xzgg, Xzgg, Xzgg, Xzgg^Qov, Xzgg^Qov, Xzg2, Xzgg^Qov, Xzg2, Xzg2, Xzg2, Xzg2^Edp, Xzg2, Xzg2, Xzg2^Qov, Xzg2, Xzg2, Xzg2, Rd, Rd, Rd, Xzg2, Xzg2, Xzg2^Qov, Xzg3, Xzg3, Xzg3, Xzg3, Xzg3, Rd, Xzg3, Re, Dd, Re, Rd, Rd, Re, Rd, Dd, Dd, Dd, Dd
Wot, Wot, Wot, Wot, Wot, Wwrt, Wwrt, Wot, Ww, Ww, Ww, Wwf, Ds, Ds, Ds, Ds, Xzgg^Vdt, Xzgg, Rd, Xzgg, Xzgg^Edp, Xzgg^Qov, Xzgg^Edp, Xzgg^Qov, Xzg2, Xzg2, Xzg2^Edp, Xzg2^Edp, Xzg2, Xzg2, Xzg2, Xzg2, Xzg2, Rd, Xzg2, Rd, Xzg2^Edp, Xzg2, Xzg2, Xzg2^Qov, Xzg3, Xzg3, Rd, Xzg3, Xzg3, Re, Re, Re, Dd, Rd, Dd, Rd, Dd, Dd, Dd, Dd, Dd
Wot, Wot, Wot, Wot, Wwrt, Wot, Wot, Ww, Ww, Ww, Wwf, Ds, Ds^Es, Ds^Es, Xzgg, Re, Re, Xzgg, Rd, Xzgg, Xzgg, Xzgg^Edp, Xzgg^Qov, Xzgg^Qov, Xzg2^Edp, Xzg2^Edp, Xzg2^Edp, Xzg2^Edp, Xzg2, Xzg2, Rd^Vdt, Xzg2, Rd, Xzg2, Xzg2, Xzg2, Xzg2^Edp, Xzg2^Edp, Xzg2^Qov, Xzg2^Qov, Xzg3, Xzg3, Rd, Xzg3, Xzg3^Qov, Xzg3^Qov, Dd, Dd, Dd, Dd, Dd, Dd, Dd, Dd^Edp, Dd^Edp, Dd, Dd
Wot, Wot, Wot, Wwrt, Wot, Wwrt, Wot, Ww, Ww, Ww, Ds, Ds, Ds, Xzgg, Rd^Vdt, Re, Re, Rd^Ecf, Rd, Xzgg^Vdt, Xzgg, Xzgg^Qov, Xzg2, Xzg2, Xzg2^Edp, Xzg2^Edp, Xzg2^Edp, Xzg2, Xzg2, Rd, Rd, Re, Rd, Rd^Vdt, Xzg2, Xzg2^Edp, Xzg2^Edp, Xzg2^Edp, Xzg2^Qov, Xzg3^Edp, Xzg3, Rd, Rd, Xzg3, Xzg3^Qov, Dd, Dd, Dd, Dd^Edp, Dd^Edp, Dd^Edp, Dd^Edp, Dd, Dd^Edp, Dd^Edp, Dd^Edp, Dd
Wot, Wot, Wot, Wot, Wot, Ww, Ww, Ww, Ww, Wwf, Wwf, Ds^Es, Ds, Ds, Rd, Rd, Rd^Vdt, Rd, Xzgg, Xzgg, Xzgg^Qov, Xzgg^Qov, Xzg2, Xzg2, Xzg2, Xzg2^Edp, Xzg2, Xzg2, Xzg2, Xzg2^Ecf, Re, Re, Re, Rd, Xzg2, Xzg2, Xzg2^Qov, Xzg2^Qov, Xzg3, Xzg3, Rd, Re, Re, Xzg3^Es, Xzg3^Qov, Dd, Dd, Dd^Edp, Dd^Edp, Dd^Edp, Dd^Edp, Dd^Edp, Dd, Dd^Es, Dd^Edp, Dd, Dd
Wot, Wot, Wot, Wot, Wot, Wot, Wot, Ww, Ww, Ww, Wwf, Wwf, Ds, Ds, Ds, Xzgg, Xzgg, Rd, Xzgg, Xzgg^Qov, Xzg2^Edp, Xzg2^Edp, Xzg2^Edp, Xzg2, Xzg2, Rd, Xzg2, Xzg2, Rd, Rd, Re, Rd^Vdt, Rd, Xzg2, Xzg2^Qov, Xzg2^Qov, Xzg3^Edp, Xzg2^Qov, Xzg3, Xzg3, Xzg3^Es, Re, Xzg3, Xzg3^Es, Xzg3^Qov, Dd, Dd, Dd, Dd, Dd^Es, Dd, Dd^Edp, Dd^Edp, Dd^Edp, Dd, Dd, Dd
Wot, Wot, Wot, Wot, Wot, Wwrt, Wot, Wot, Wot, Ww, Ww, Wwf, Wwf, Ds^Es, Ds, Xzgg^Edp, Xzgg^Edp, Xzgg, Xzgg, Xzgg^Qov, Xzg2, Xzg2^Edp, Xzg2, Xzg2, Rd, Re, Rd, Xzg2, Xzg2, Rd, Xzg2, Rd, Xzg2, Xzg2^Qov, Xzg3^Edp, Xzg3^Edp, Xzg3, Xzg3, Xzg3, Xzg3^Es, Xzg3, Xzg3, Xzg3, Xzg3, Xzg3^Edp, Xzg3^Qov, Xzg3^Qov, Dd, Dd, Dd, Dd, Dd^Edp, Dd^Edp, Dd^Es, Dd^Edp, Dd^Edp, Dd
Wot, Wot, Wot, Wot, Wot, Wwrt, Wwrt, Wot, Wwrt, Ww, Ww, Wwf, Ww, Ds, Ds^Es, Xzgg, Xzgg^Edp, Xzgg, Xzgg, Xzgg^Qov, Xzg2, Xzg2, Rd, Xzg2, Xzg2, Re, Xzg2, Xzg2, Xzg2, Xzg2, Xzg2, Xzg2, Xzg2^Qov, Xzg2^Qov, Xzg3, Xzg3^Edp, Xzg3, Rd, Re, Xzg3, Rd^Vdt, Rd, Xzg3^Edp, Xzg3, Xzg3, Xzg3^Edp, Xzg3^Edp, Xzg3^Qov, Dd, Dd, Dd, Dd, Dd, Dd^Edp, Dd, Dd, Dd
Wot, Wot, Wot, Wot, Wot, Wot, Wwrt, Wwrt, Wwrt, Wot, Ww, Ww, Ww, Ds, Ds, Ds, Xzgg, Xzgg, Xzgg, Xzgg^Qov, Xzgg, Rd, Rd, Xzg2, Xzg2, Xzg2, Xzg2^Edp, Xzg2^Edp, Xzg2^Edp, Xzg2, Xzg2, Xzg2^Qov, Xzg3, Xzg3, Xzg3, Xzg3^Es, Xzg3, Re, Rd^Ecf, Re, Re, Rd, Rd, Xzg3, Xzg3, Xzg3^Edp, Xzg3^Edp, Xzg3^Qov, Xzg3^Qov, Dd, Xzg3^Qov, Dd, Dd, Dd, Dd, Dd, Dd
Wot, Wot, Wot, Wot, Wot, Wwrt, Wwrt, Wwrt, Wwrt, Wot, Ww, Ww, Ww, Ds, Ds, Ds, Ds, Ds, Xzgg, Rd, Re, Re, Rd, Rd, Xzg2, Xzg2, Xzg2, Xzg2^Edp, Xzg2^Edp, Xzg2, Xzg2^Qov, Xzg2^Qov, Xzg3^Edp, Xzg3, Xzg3, Xzg3, Rd, Rd, Re, Re, Re, Re, Rd, Xzg3^Vdt, Xzg3, Xzg3, Xzg3, Xzg3, Xzg3, Xzg3^Qov, Xzg3, Xzg3^Qov, Xzg3^Qov, Xzg3^Qov, Xzg3^Qov, Xzg3^Qov, Xzg3^Qov
Wot, Wot, Wot, Wot, Wot, Wot, Wot, Wwrt, Wwrt, Wwrt, Wwrt, Ww, Ww, Wwf, Ds, Ds, Ds, Ds, Ds, Rd, Xzgg, Xzgg, Xzg2, Xzg2, Xzg2, Xzg2, Xzg2^Edp, Xzg2^Edp, Xzg2^Edp, Xzg2, Xzg2^Qov, Xzg3, Xzg3^Edp, Xzg3^Edp, Xzg3, Rd, Xzg3, Rd^Vdt, Rd, Re, Re, Rd^Vdt, Rd, Rd, Xzg3, Xzg3^Edp, Xzg3^Edp, Xzg3, Xzg3^Edp, Xzg3, Xzg3, Xzg3, Xzg3, Xzg3, Xzg3, Xzg3, Xzg3^Edp
Wot, Wot, Wot, Wot, Wot, Wot, Wot, Wwrt, Wot, Ww, Wot, Ww, Ww, Wwf, Wwf, Wwf, Wwf, Ds, Ds, Xzgg, Xzgg, Xzgg^Qov, Xzgg^Qov, Xzg2, Xzg2, Xzg2, Xzg2^Edp, Xzg2, Xzg2, Xzg2, Xzg2^Qov, Xzg3^Edp, Xzg3^Es, Xzg3^Edp, Xzg3^Edp, Xzg3, Xzg3, Xzg3, Xzg3, Xzg3, Rd^Vdt, Re, Re, Xzg3, Xzg3, Xzg3, Xzg3^Edp, Xzg3^Edp, Xzg3^Edp, Xzg3, Xzg3^Edp, Xzg3, Xzg3^Edp, Xzg3^Edp, Xzg3^Edp, Xzg3^Edp, Xzg3^Edp
Wot, Wot, Wot, Wot, Wot, Wot, Wot, Wot, Wot, Wot, Wot, Ww, Ww, Ww, Ww, Wwf, Wwf, Ds, Ds, Ds, Ds, Xzgg, Xzgg, Xzgg^Qov, Xzgg^Qov, Xzg2, Xzg2, Xzg2, Xzg2, Xzg2, Xzg2^Qov, Xzg3, Xzg3, Xzg3^Edp, Xzg3^Edp, Xzg3^Edp, Xzg3, Xzg3, Xzg3, Xzg3, Xzg3, Rd, Xzg3, Xzg3, Xzg3, Xzg3, Xzg3, Xzg3^Es, Xzg3^Edp, Xzg3^Edp, Xzg3, Xzg3, Xzg3^Edp, Xzg3^Edp, Xzg3^Es, Xzg3^Edp, Xzg3
Wot, Wot, Wot, Wot, Wot, Wot, Wot, Wot, Wot, Wot, Wot, Ww, Ww, Ww, Ww, Wwf, Ww, Ds, Ds, Ds, Xzgg, Xzgg, Xzgg, Xzgg, Xzgg^Qov, Xzg2, Xzg2, Xzg2, Xzg2, Xzg2, Xzg2, Xzg2^Qov, Xzg2^Qov, Xzg3, Xzg3, Xzg3, Xzg3, Xzg3^Edp, Xzg3, Xzg3, Xzg3, Xzg3, Xzg3, Xzg3^Es, Xzg3, Xzg3, Xzg3, Xzg3^Edp, Xzg3, Xzg3, Xzg3^Edp, Xzg3^Edp, Xzg3, Xzg3^Edp, Xzg3, Xzg3^Edp, Xzg3
