Wot, Wot, Wot, Ww, Wot, Wot, Wot, Wot, Wot, Wot, Wot, Wot, Wot, Ww, Ww, Wot, Wot, Wot, Ww, Ww, Wot, Ww, Wot, Wot, Wot, Wot, Wot, Ww, Ww, Ww, Ww, Ww, Wot, Ww, Wot, Ww, Wot, Ww, Wot, Wot, Wot, Wot, Wot, Wot, Wot, Wot, Wot, Wot
Wot, Wot, Wot, Wot, Wot, Wot, Wot, Wot, Wwrt, Wot, Wwrt, Wot, Wwrt, Ww, Ds, Ww, Ww, Wot, Wot, Wot, Wot, Wot, Wot, Wot, Ww, Wot, Ww, Ww, Ww, Ww, Ww, Ww, Ww, Ww, Ww, Wwrt, Wwrt, Wot, Wot, Wot, Wot, Wot, Wot, Wot, Wwrt, Wot, Wot, Wot
Wot, Wot, Wot, Wot, Wot, Wot, Wot, Wwrt, Wwrt, Wwrt, Wwrt, Wwrt, Wwrt, Ww, Ww, Ds, Ww, Ww, Ww, Wot, Ww, Wot, Ww^Qov, Ww^Qov, Ww^Qov, Ww^Qov, Ww^Qov, Ww^Qov, Ww^Qov, Ds, Ds, Ds, Ww, Ww, Ww, Ww, Ww, Wwrt, Wwrt, Wwrt, Wwrt, Wwrt, Wwrt, Wot, Ww, Wot, Wot, Wot
Ww, Wot, Wot, Wot, Wot, Wot, Wot, Wwrt, Ww, Ww, Ww, Wwrt, Ww, Wwrt, Wwrt, Ww, Ww, Ww, Ds, Ww, Ww, Ww, Dd^Qov, Tptz, Tptz, Tptz, Tptz, Tptz, Dd^Qov, Dd, Dd^Edp, Ds, Ds, Ww, Ds, Ww, Wwf, Ww, Wwf, Wwrt, Ww, Ww, Ww, Ww, Ww, Ww, Wwrt, Wot
Wot, Wot, Wot, Wot, Wot, Wot, Wot, Wot, Wwrt, Ww, Ds, Ww, Ww, Ww, Ds, Ds, Ds^Rusy, Ds, Ds, Ds, Xzg3, Dd^Qov, Tptz, Tptz, Tptz, Tptz, Tptz, Tptz, Tptz, Dd^Qov, Dd^Edp, Dd, Dd, Dd, Ds, Ds, Wwf, Wwf, Wwf, Ds, Ds, Ww, Ds, Ds, Wwf, Wwrt, Wwrt, Wwrt
Wot, Wot, Wot, Wot, Wot, Wot, Wwrt, Wwrt, Wwrt, Ww, Ds, Ds, Ww, Ds, Ds, Ds^Rusy, Xzg3, Xzg3, Dd^Qov, Xzg3, Dd^Qov, Dd^Qov, Tptz, Tptz, Tptz, Tptz, Tptz, Tptz, Tptz, Dd^Qov, Dd^Qov, Dd^Edp, Dd, Dd^Es, Xzg3, Ds, Ds, Wwf, Ds, Ds, Xzg2, Ds, Xzg2, Ds, Ds, Wwf, Wwf, Wwrt
Wot, Wot, Wot, Wot, Wot, Wot, Ww, Wwrt, Ww, Ds, Ww, Ww, Ds, Ds, Ds, Xzg3^Rusy, Xzg3, Xzg3, Dd^Qov, Dd^Qov, Tptz^Kov, Tptz^Qov, Tphz, Tptz, Tphz, Tptz, Tphz, Tptz, Tphz, Tptz^Qov, Tptz^Kov, Dd^Qov, Xzg3^Qov, Xzg3^Qov, Xzg3, Xzg3^Edp, Xzg3^Qov, Ds, Xzg3, Ds, Xzg2, Xzg2^Es, Xzg2^Es, Xzg2^Edp, Ds, Wwf, Wwf, Ww
Ww, Wot, Wot, Wot, Wot, Ww, Ww, Wwrt, Ww, Ww, Ds, Ds, Ds, Ds, Ds, Xzg3, Xzg3, Dd^Qov, Dd^Qov, Dd^Qov, Tptz^Kov, Tptz^Kov, Tphz, Tphz, Tphz, Tphz, Tphz, Tphz, Tphz, Tptz^Kov, Tptz^Kov, Dd^Qov, Dd^Qov, Xzg3, Xzg3, Xzg3^Qov, Dd, Dd, Xzg3^Qov, Xzg3^Es, Xzg3, Xzg2, Xzg2^Es, Xzg2^Es, Ds, Ds, Wwf, Wwf
Ww, Wot, Ww, Wot, Ww, Ww, Ww, Ww, Ww, Wwf, Ds, Ds, Ds, Xzg3, Xzg3, Xzg3^Edp, Xzg3, Xzg3, Dd^Qov, Tptz^Kov, Gd^Fts, Tptz^Kov, Gd^Fts, Tphz^Tpwz, Gd^Fts, Tphz^Tyod, Gd^Fts, Tphz^Tpwz, Gd^Fts, Tptz^Kov, Gd^Fts, Tptz^Kov, Dd^Qov, Xzg3, Xzg3^Edp, Xzg3^Qov, Xzg3^Qov, Xzg3^Qov, Xzg3, Xzg3, Xzg2^Qov, Xzg2, Xzg2, Xzg2, Xzg2^Edp, Ds, Ds, Ds
Ww, Ww, Ww, Ww, Ww, Ww, Wwf, Wwf, Ds, Wwf, Ds, Ds, Xzg3, Xzg3, Xzg3, Xzg3^Edp, Xzg3^Edp, Dd^Qov, Dd^Qov, Tptz^Kov, Tptz^Kov, Tptz^Kov, Tptz^Kov, Gg^Fet, Tptz^Kov, Tptz^Kov, Tptz^Kov, Gd^Fts, Tptz^Kov, Tptz^Kov, Tptz^Kov, Tptz^Kov, Dd^Qov, Xzg3, Xzg3, Xzg3, Xzg3^Es, Xzg3^Edp, Xzg3, Xzg3^Es, Xzg2^Qov, Xzg2, Xzg2^Es, Xzg2^Edp, Xzg2^Edp, Xzg2^Es, Ds, Ds
Wwf, Wwf, Ds, Wwf, Wwf, Ww, Wwf, Wwf, Xzg3^Edp, Ds, Ds, Ds, Xzg3, Xzg3, Xzg3, Xzg3^Edp, Xzg3^Edp, Xzg3^Edp, Dd^Qov, Tptz^Kov, Tptz^Kov, Gd^Fts, Tptz^Kov, Tptz^Kov, Tptz^Kov, Tptz^Kov, Tptz^Kov, Tptz^Kov, Tptz^Kov, Gd^Fts, Tptz^Kov, Tptz^Kov, Dd^Qov, Dd^Qov, Xzg3, Xzg3^Es, Xzg3, Xzg3, Xzg3^Es, Xzg3^Es, Xzg2^Qov, Xzg2, Xzg2^Es, Xzg2, Xzg2^Es, Xzg2, Xzg2, Xzg2
Ds, Ds, Ds, Ds, Wwf, Wwf, Wwf, Ds, Xzg3^Es, Ds, Xzg3, Xzg3, Dd^Qov, Xzg3, Xzg3, Xzg3^Edp, Xzg3, Xzg3^Qov, Dd^Qov, Tptz^Kov, Tptz^Kov, Tptz^Kov, Tptz^Kov, Tptz^Kov, Tptz^Kov, 2 Tptz^Kov, Tptz^Kov, Tptz^Kov, Tptz^Kov, Tptz^Kov, Tptz^Kov, Tptz^Kov, Dd^Qov, Xzg3^Qov, Xzg3, Xzg3, Dd^Qov, Xzg3, Xzg3, Xzg3, Xzg3, Xzg2^Qov, Xzg2^Qov, Xzg2^Qov, Xzg2^Qov, Xzg2, Xzg2, Xzg2
Ds, Ds, Xzg2, Ds, Ds, Wwf, Wwf, Ds, Ds, Xzg3, Xzg3, Dd^Qov, Dd, Dd^Qov, Dd^Qov, Xzg3, Dd^Qov, Dd^Qov, Tptz, Tphz, Tphz, Tphz, Tphz, Tptz^Kov, Tphz, Tptz^Kov, Tphz, Tptz^Kov, Tphz, Tphz, Tphz, Tphz, Tptz, Dd^Qov, Dd^Qov, Dd^Qov, Dd^Qov, Dd^Qov, Xzg3, Xzg3, Xzg3, Xzg3, Xzg3, Xzg3, Xzg2^Qov, Xzg2, Xzg2, Xzg2
Xzg2, Xzg2, Ds, Ds, Wwf, Ds, Wwf, Ds, Xzg3, Xzg3, Dd^Qov, Xzg3^Qov, Dd^Edp, Dd, Dd, Dd^Qov, Dd^Es, Dd^Qov, Tptz, Tphz^Tpwz, Tphz, Tphz, Tphz, Tphz, Tphz, Tphz, Tphz, Tphz, Tphz, Tphz, Tphz, Tphz^Tpwz, Tptz, Dd^Qov, Dd^Es, Dd^Qov, Xzg3^Qov, Xzg3^Qov, Xzg2^Qov, Xzg2^Qov, Xzg2^Qov, Xzg2^Qov, Xzg2^Qov, Xzg3, Xzg2^Qov, Xzg2, Xzg2, Xzg2
Xzg2, Xzg2^Es, Ds, Ds, Ds, Wwf, Ds, Ds, Xzg3, Xzg3, Dd^Qov, Dd^Edp, Dd, Dd^Edp, Dd, Dd, Dd^Qov, Dd^Qov, Tptz, Tphz, Tphz, Tphz, Tphz^Tpwz, Tphz, Tphz, Tphz, Tphz, Tphz, Tphz^Tpwz, Tphz, Tphz, Tphz, Tptz, Dd^Qov, Dd^Qov, Dd^Qov, Xzg3, Xzg3, Xzg2^Qov, Xzg2^Edp, Xzg2^Edp, Xzg2, Xzg2^Edp, Xzg2^Qov, Xzg2, Xzg2, Xzg2, Xzg2
Xzg2, Xzg2, Xzg2^Edp, Ds, Xzg2, Ds, Xzg3, Xzg3, Dd^Qov, Dd^Qov, Dd^Es, Dd, Dd^Es, Dd^Es, Dd, Dd, Dd^Qov, Tptz, Gd^Fts, Tphz, Tphz^Tyod, Tphz, Tphz, Tphz, Tphz, Tphz, Tphz, Tphz, Tphz, Tphz, Tphz^Tycd, Tphz, Gd^Fts, Tptz, Dd^Qov, Dd^Qov, Xzg3, Xzg3, Xzg2^Qov, Xzg2^Edp, Xzg2^Qov, Xzg2^Qov, Xzg2^Qov, Xzg2^Edp, Xzg2^Edp, Xzg2^Edp, Xzg2^Edp, Xzg2
Xzg2, Xzg2^Edp, Xzg2^Edp, Xzg2, Xzg2, Xzg2, Xzg2^Qov, Xzg3^Qov, Xzg3, Dd, Dd, Dd, Dd^Es, Dd^Edp, Dd^Es, Dd^Qov, Tptz, Tptz, Gd^Fts, Gd, Tptz, Tptz, Gd^Fts, Tphz, Gd, Tphz^Tyod, Gd, Tphz, Gd^Fts, Tptz, Tptz, Gd^Fts, Gd^Fts, Tptz, Tptz, Dd^Qov, Xzg3, Xzg3^Es, Xzg3^Es, Xzg2^Qov, Xzg3, Xzg3, Xzg3^Es, Xzg2^Qov, Xzg2^Qov, Xzg2^Edp, Xzg2, Xzg2
Xzg2^Es, Xzg2, Xzg2, Xzg2^Edp, Xzg2^Edp, Xzg2, Xzg2^Qov, Xzg3, Xzg3, Xzg3, Dd, Dd, Dd, Dd^Es, Dd^Qov, Dd^Qov, Tptz, Tptz, Tptz, Tptz, Tptz, Tptz, Tptz, Gd^Fts, Tptz, Tptz, Tptz, Gd^Fts, Tptz, Tptz, Tptz, Tptz, Tptz, Tptz, Tptz, Dd^Qov, Dd^Qov, Xzg3^Es, Xzg3, Xzg3, Dd, Xzg3^Es, Xzg3^Es, Xzg3, Xzg2^Qov, Xzg2, Xzg2^Qov, Xzg2^Qov
Xzg2^Es, Xzg2, Xzg2^Edp, Xzg2^Edp, Xzg2^Edp, Xzg2, Xzg2^Qov, Xzg3, Xzg3, Dd, Dd, Xzg3, Dd, Dd, Dd^Qov, Tptz, Tptz, Tptz, Tptz, Tptz, Gd^Fts, Tptz, Tptz, Tptz, Tptz, Tptz, Tptz, Tptz, Tptz, Tptz, Gd^Fts, Tptz, Tptz, Tptz, Tptz, Tptz, Dd^Qov, Dd, Xzg3, Xzg3, Dd, Dd, Xzg3, Xzg3, Xzg2^Qov, Xzg2^Qov, Xzg3, Xzg3
Xzg2, Xzg2, Xzg2^Es, Xzg2^Edp, Xzg2^Edp, Xzg2^Qov, Xzg3, Xzg3, Xzg3^Qov, Dd, Xzg3^Qov, Xzg3^Qov, Dd^Qov, Dd^Qov, Tptz^Qov, Tptz, Tptz, Tptz, Tptz, Tptz, Tptz, Tptz, Tptz^Ebn, Tptz, Tptz, Tptz, Tptz, Tptz, Tptz^Ebn, Tptz, Tptz, Tptz, Tptz, Tptz, Tptz, Tptz, Tptz^Qov, Dd^Qov, Dd^Qov, Xzg3, Dd, Xzg3, Xzg3, Xzg2^Qov, Xzg3, Xzg2^Qov, Xzg3, Xzg3
Xzg2, Xzg2^Es, Xzg2, Xzg2^Es, Xzg2, Xzg2^Qov, Xzg2^Qov, Xzg3^Qov, Dd, Xzg3^Qov, Dd, Dd, Dd^Qov, Tptz, Tptz, Tphz, Tphz, Tphz, Tphz, Tptz, Tphz, Tptz, Tptz, Tptz, Tphz, Tptz, Tphz, Tptz, Tptz, Tptz, Tphz, Tptz, Tphz, Tphz, Tphz, Tphz, Tptz, Tptz, Dd^Qov, Dd, Dd^Es, Xzg3, Xzg3, Xzg2^Qov, Xzg2^Qov, Xzg3, Dd, Dd
Xzg3^Qov, Xzg2, Xzg3^Qov, Xzg2, Xzg2, Xzg2, Xzg2, Xzg3^Qov, Dd^Edp, Dd^Edp, Dd^Qov, Dd^Qov, Tptz, Tptz, Gd^Fts, Tphz^Tpwz, Tphz, Tphz, Tphz, Tphz, Tphz, Tphz, Tphz, Tphz, Tphz, Tphz, Tphz, Tphz, Tphz, Tphz, Tphz, Tphz, Tphz, Tphz, Tphz, Tphz^Tpwz, Gd^Fts, Tptz, Tptz, Dd^Qov, Dd^Qov, Dd, Xzg3, Xzg3, Xzg2^Qov, Xzg3, Dd, Dd
Xzg3^Qov, Xzg3^Qov, Xzg3^Es, Xzg3^Qov, Xzg3^Qov, Xzg2, Xzg3^Qov, Xzg3^Qov, Dd, Dd^Edp, Dd^Qov, Tptz, Tptz, Gd^Fts, Gd^Fts, Tphz, Tphz^Tyod, Tphz, Tphz, Tphz^Tpwz, Tphz, Tphz, Tphz, Tphz, Tphz, Tphz, Tphz, Tphz, Tphz, Tphz, Tphz, Tphz^Tpwz, Tphz, Tphz, Tphz^Tyod, Tphz, Gd^Fts, Gd^Fts, Tptz, Tptz, Dd^Qov, Dd^Es, Xzg3, Xzg2^Qov, Xzg2^Qov, Xzg3, Dd, Dd
Dd, Xzg3^Qov, Xzg3^Qov, Xzg3^Qov, Dd^Edp, Rd, Dd, Xzg3^Qov, Xzg3^Qov, Dd, Dd^Qov, Tptz, Tptz, Tptz, Tptz, Gd^Fts, Tptz, Gd, Gd^Fts, Tphz, Tptz, Tphz, Tphz, Tphz, Gd, Tphz^Tyod, Gd, Tphz, Tphz, Tphz, Tptz, Tphz, Gd^Fts, Gd, Tptz, Gd^Fts, Tptz, Tptz, Tptz, Tptz, Dd^Qov, Dd, Xzg3, Xzg2^Qov, Xzg2^Qov, Xzg3, Xzg3, Xzg3
Dd, Dd^Edp, Dd^Edp, Dd^Edp, Rd, Rd, Dd, Xzg3^Qov, Xzg3^Qov, Dd, Dd^Qov, Tptz, Tptz, Tptz, Tptz, Tptz, Tptz, Tptz, Tptz, Tptz, Tptz, Tptz, Gd^Fts, Gd, Gd^Fts, Tptz, Gd^Fts, Gd, Gd^Fts, Tptz, Tptz, Tptz, Tptz, Tptz, Tptz, Tptz, Tptz, Tptz, Tptz, Tptz, Dd^Qov, Dd, Dd, Xzg3, Xzg3, Xzg2^Qov, Xzg2^Qov, Xzg3
Dd, Dd, Dd^Es, Dd^Es, Dd^Edp, Dd^Edp, Xzg3^Qov, Xzg3^Qov, Xzg3^Qov, Xzg3^Qov, Dd^Qov, Tptz, Tptz^Ebn, Tptz, Gd^Fts, Tptz, Tptz, Tptz, Tptz, Tptz, Tptz, Tptz, Tptz, Gd^Fts, Tptz, Tptz, Tptz, Gd^Fts, Tptz, Tptz, Tptz, Tptz, Tptz, Tptz, Tptz, Tptz, Gd^Fts, Tptz, Tptz^Ebn, Tptz, Dd^Qov, Dd^Qov, Dd, Dd, Xzg3, Xzg2^Qov, Xzg2^Qov, Xzg2^Qov
Dd, Dd^Es, Dd^Es, Dd^Edp, Dd, Xzg3^Qov, Xzg3^Qov, Xzg3^Es, Xzg3^Qov, Dd, Dd^Qov, Tptz, Tptz, Tptz, Tptz, Tptz, Tptz, Tptz, Tptz, Tptz, Gd^Fts, Tptz, Tptz, Tptz, Tptz, Tptz, Tptz, Tptz, Tptz, Tptz, Gd^Fts, Tptz, Tptz, Tptz, Tptz, Tptz, Tptz, Tptz, Tptz, Tptz, Dd^Qov, Dd, Xzg3, Xzg3, Xzg2^Qov, Xzg2^Qov, Xzg3^Qov, Xzg3^Qov
Rd, Dd^Rusy, Dd, Dd, Xzg3, Dd, Dd, Xzg3^Qov, Xzg3^Qov, Xzg3^Qov, Dd, Tphz, Tphz, Tptz, Tptz, Tptz, Tptz, Tptz, Tptz, Tptz, Tptz, Tptz, Tptz, Gd^Fts, Gd^Fts, Tptz, Gd^Fts, Gd^Fts, Tptz, Tptz, Tptz, Tptz, Tptz, Tptz, Tptz, Tptz, Tptz, Tptz, Tphz, Tphz, Dd^Qov, Dd, Xzg3, Xzg3, Xzg3^Qov, Xzg3^Qov, Dd, Dd
Rd, Dd, Rd, Dd, Xzg3, Xzg3, Dd^Es, Dd^Es, Dd^Es, Dd, Dd, Tphz, Tphz, Tphz, Tphz, Tptz, Tptz, Tptz, Tptz, Tptz, Tptz, Tptz, Tptz, Tptz, Tptz, Tptz, Tptz, Tptz, Tptz, Tptz, Tptz, Tptz, Tptz, Tptz, Tptz, Tptz, Tphz, Tphz, Tphz, Tphz, Dd, Xzg3^Qov, Xzg3^Qov, Xzg3^Qov, Dd, Xzg3^Qov, Dd, Dd
Re, Re, Rd, Dd, Dd, Dd, Dd^Vdt, Dd^Es, Ce, Dd^Es, Dd, Tphz, Tphz, Tphz, Tphz, Tphz, Tphz, Tphz, Tphz, Tptz, Tphz, Tphz, Tphz, Tptz, Tphz, Tptz, Tphz, Tptz, Tphz, Tphz, Tphz, Tptz, Tphz, Tphz, Tphz, Tphz, Tphz, Tphz, Tphz, Tphz, Dd^Edp, Dd^Es, Dd^Es, Xzg3^Qov, Dd, Dd, Re, Dd
Dd, Rd, Dd, Dd, Rd, Rd, Re, Re, Rd, Dd, Dd, Tphz, Tphz, Tphz, Tphz, Tphz, Tphz, Tphz, Tphz, Tphz, Tphz, Tphz, Tphz, Tphz, Tphz, Tphz, Tphz, Tphz, Tphz, Tphz, Tphz, Tphz, Tphz, Tphz, Tphz, Tphz, Tphz, Tphz, Tphz, Tphz, Dd^Edp, Dd^Edp, Dd^Es, Dd, Rd, Rd, Re, Re
Dd, Dd, Dd, Dd, Dd^Edp, Rd, Dd, Rd, Rd, Rd, Dd^Qov, Dd^Qov, Iwr, Tphz, Tphz, Tphz, Tphz, Tphz, Tphz, Tphz, Tphz, Tphz, Tphz, Tphz, Tphz, Tphz, Tphz, Tphz, Tphz, Tphz, Tphz, Tphz, Tphz, Tphz, Tphz, Tphz, Tphz, Tphz, Dd, Dd, Dd, Dd, Dd^Vdt, Dd, Rd, Rd, Rd, Rd
Xzg3^Qov, Xzg3^Qov, Xzg3^Qov, Dd, Dd^Edp, Dd^Edp, Dd, Dd^Vdt, Rd, Re, Rd, Iwr, Iwr, Iwr, Iwr, Tphz, Tphz, Tphz, Tphz, Tphz, Tphz, Tphz, Tphz, Tphz, Tphz, Tphz, Tphz, Tphz, Tphz, Tphz, Tphz, Tphz, Tphz, Tphz, Tphz, Tphz, Dd^Edp, Dd, Dd^Edp, Dd, Re, Re, Re, Rd, Ce, Rd, Dd, Dd
Xzg2, Xzg3, Xzg3^Qov, Dd^Edp, Xzg3^Qov, Xzg3^Qov, Xzg3^Qov, Dd, Dd, Re, Re, Re, Dd, Rd, Re, Rd, Rd, Dd, Re, Tphz^Tyod, Rd, Dd, Dd, Tphz, Rd, Tphz, Dd, Tphz, Dd, Rd, Rd, Tphz^Tyod, Rd, Dd, Rd, Dd, Dd^Rusy, Dd^Edp, Dd^Es, Dd^Edp, Rd, Rd, Re, Dd, Dd^Edp, Dd^Edp, Dd^Edp, Dd^Edp
Xzg3, Xzg2, Xzg3, Xzg3^Qov, Xzg3, Xzg2, Xzg2, Xzg3^Qov, Dd, Dd^Es, Re, Rd, Rd, Dd, Dd^Es, Rd, Rd, Rd, Re, Re, Rd, Dd, Dd^Vdt, Dd, Dd, Dd, Rd, Dd, Dd^Vdt, Dd, Rd, Re, Re, Rd, Dd^Edp, Dd^Edp, Dd^Rusy, Dd^Rusy, Dd, Rd, Rd, Dd, Dd^Vdt, Dd^Es, Dd^Es, Xzg3^Qov, Xzg3^Qov, Xzg3^Qov
Xzg3, Xzg3, Xzg3, Xzg3, Xzg2, Xzg2, Xzg3, Xzg3^Qov, Dd, Dd^Es, Re, Re, Rd, Dd, Dd, Dd^Vda, Dd^Edp, Dd^Es, Rd, Rd, Rd, Dd, Rd, Dd, Dd, 3 Dd, Rd, Dd, Rd^Es, Dd, Dd^Vda, Re, Re, Dd, Dd, Dd, Dd, Dd^Rusy, Dd, Rd, Dd, Dd, Dd, Dd^Es, Dd^Es, Dd, Xzg3^Qov, Xzg3
Xzg3, Xzg2, Xzg2, Xzg2, Xzg3^Es, Xzg3, Xzg3^Qov, Xzg3^Qov, Dd, Re, Re, Rd, Dd, Re, Rd, Rd, Dd, Dd^Es, Dd^Edp, Dd^Ebn, Dd, Rd, Rd, Rd, Rd, Rd, Rd, Re, Rd^Es, Rd^Es, Rd^Es, Dd^Ebn, Rd, Re, Re^Es, Rd, Dd^Vdt, Dd, Dd, Dd, Dd^Eff, Dd, Xzg3^Qov, Dd, Dd, Xzg3^Qov, Xzg3, Xzg3
Xzg3, Xzg2, Xzg2^Es, Xzg2, Xzg3, Xzg3^Qov, Dd, Dd, Dd^Es, Rd, Rd, Rd, Rd, Rd, Rd, Rd, Dd, Dd^Edp, Dd, Dd, Dd^Es, Rd, Rd, Rd, Rd, Rd, Rd, Rd, Rd, Rd^Es, Rd^Es, Rd, Dd^Vda, Rd^Es, Re, Re, Rd, Rd, Rd^Eff, Dd^Eff, Dd, Xzg3^Qov, Dd, Xzg3^Qov, Xzg3^Qov, Xzg3^Qov, Xzg2, Xzg2
Xzg3, Xzg3, Xzg2, Xzg2, Xzg2, Xzg3^Qov, Dd, Dd^Es, Dd^Es, Dd, Dd, Dd, Dd, Re, Rd, Rd, Rd, Rd, Rd, Dd, Rd, Rd, Rd, Rd, Rd, Rd, Rd, Rd, Dd^Vdt, Dd, Rd, Rd, Rd, Dd, Dd^Edp, Dd, Dd^Edp, Dd^Eff, Dd^Eff, Dd, Dd^Es, Dd^Edp, Dd^Edp, Dd, Xzg3^Qov, Xzg2, Xzg2, Xzg2
Xzg3^Qov, Xzg3^Qov, Xzg3^Qov, Xzg3^Qov, Xzg3^Qov, Xzg3^Qov, Xzg3^Qov, Dd^Edp, Dd^Rusy, Dd, Dd, Dd, Dd, Rd, Dd, Re, Rd, Rd, Rd, Rd, Rd, Dd^Vda, Dd, Dd^Vda, Dd^Ebn, Rd, Rd, Rd, Rd, Dd, Rd, Rd, Rd, Dd^Vda, Dd^Edp, Dd^Edp, Dd, Dd, Dd, Dd, Dd, Dd, Dd, Dd, Dd^Eff, Xzg3^Qov, Xzg2, Xzg2
Dd, Dd, Dd^Es, Dd, Xzg3^Qov, Xzg3^Qov, Dd, Dd, Dd^Rusy, Dd^Rusy, Dd^Edp, Dd, Dd^Edp, Dd, Dd^Edp, Dd^Es, Rd, Rd, Rd, Rd, Rd, Rd, Rd, Dd^Es, Dd^Vda, Rd, Rd, Dd, Rd, Rd^Es, Dd, Re, Rd, Dd^Edp, Dd^Edp, Dd^Edp, Dd, Dd, Dd, Dd, Dd, Dd^Eff, Dd^Eff, Dd^Eff, Xzg3^Qov, Xzg3^Qov, Xzg2, Xzg2
Dd, Dd^Es, Dd, Dd^Es, Dd, Dd, Rd, Dd, Re, Rd, Dd, Dd^Edp, Dd, Dd, Dd^Edp, Dd, Rd, Rd, Rd, Dd^Vdt, Dd, Re, Re, Dd, Rd, Re, Rd, Rd, Rd, Dd, Rd, Rd, Rd, Rd, Rd, Rd, Re, Rd, Dd, Dd, Dd^Es, Dd, Xzg3^Qov, Xzg3^Qov, Xzg2, Xzg3, Xzg2, Xzg2
Re, Re, Re, Rd, Re, Rd, Rd, Rd, Rd, Re, Re, Dd^Vdt, Rd, Re, Re, Re, Re, Re, Dd^Es, Rd, Rd, Rd, Re, Rd, Dd, Rd, Dd, Rd, Rd, Rd, Rd, Rd, Dd, Rd, Rd, Rd, Rd, Rd, Re, Dd^Es, Dd^Es, Dd, Xzg3^Qov, Xzg2, Xzg2, Xzg2, Xzg3^Qov, Xzg3
Dd, Rd, Dd^Edp, Re, Dd, Re, Dd, Ce, Dd, Re, Re, Rd, Rd, Rd, Re, Re, Rd, Dd, Dd, Dd^Es, Dd, Dd, Ket, Ce, Dd, Dd^Vdt, Dd, Dd^Es, Dd, Rd, Dd, Rd, Dd, Dd^Vdt, Dd^Es, Dd, Re, Re, Rd, Dd^Es, Rd, Dd, Dd, Xzg3^Qov, Xzg3^Qov, Xzg3^Qov, Dd, Xzg3^Qov
Dd, Dd, Dd^Edp, Dd^Edp, Xzg3^Qov, Dd, Xzg3^Qov, Dd^Edp, Dd^Edp, Rd, Dd^Edp, Re, Rd, Dd, Dd, Dd^Vda, Dd, Dd^Vda, Dd^Edp, Dd^Edp, Dd^Rusy, Ce, Dd^Edp, Ce, Dd, Dd, Dd, Dd, Dd^Ebn, Dd, Rd, Rd, Rd, Dd^Es, Dd^Es, Dd, Rd, Re, Dd, Rd, Rd, Rd, Rd, Dd, Dd^Edp, Dd, Dd, Xzg3^Qov
Xzg3^Qov, Xzg3^Qov, Xzg3^Qov, Xzg3^Qov, Xzg3, Xzg3^Qov, Xzg3^Qov, Dd, Rd, Dd^Edp, Dd, Dd, Dd, Dd^Vda, Dd, Dd^Edp, Dd, Dd^Edp, Dd^Edp, Dd^Edp, Dd^Edp, Dd^Rusy, Dd, Dd^Edp, Dd, Dd, Xzg3^Qov, Xzg3^Qov, Xzg3^Qov, Rd, Re, Rd, Rd, Dd, Dd^Es, Dd, Dd, Rd, Dd, Dd, Dd, Ce, Re, Re, Dd, Rd, Re, Dd
Xzg3, Xzg2^Qov, Xzg2^Qov, Xzg3, Xzg3, Dd^Qov, Xzg3^Qov, Dd, Rd, Rd, Xzg3^Qov, Dd, Xzg3^Qov, Dd, Xzg3^Qov, Dd, Dd, Dd^Edp, Dd^Edp, Dd^Edp, Dd^Edp, Dd^Edp, Dd, Xzg3^Qov, Xzg3^Qov, Xzg3^Qov, Xzg2^Qov, Xzg3, Xzg2^Qov, Xzg3, Re, Xzg3, Xzg3, Dd, Dd^Ebn, Dd^Edp, Dd, Rd, Rd, Dd, Xzg3^Qov, Dd, Dd, Re, Re, Re, Rd, Re
Xzg2^Qov, Xzg2^Qov, Xzg2^Qov, Xzg2^Qov, Xzg3, Xzg3^Qov, Xzg3^Edp, Xzg3^Qov, Rd, Xzg3, Xzg3, Xzg3^Qov, Xzg3, Xzg3^Qov, Xzg3, Xzg3^Qov, Xzg3^Qov, Dd, Dd, Dd^Edp, Dd, Dd^Edp, Xzg3^Qov, Xzg3^Qov, Xzg3^Edp, Xzg2^Qov, Xzg2^Es, Xzg2^Qov, Xzg2, Re, Rd, Re, Xzg3^Es, Xzg3^Qov, Xzg3^Qov, Xzg3^Qov, Xzg3^Qov, Xzg3, Rd, Xzg3^Qov, Xzg3, Xzg3^Qov, Xzg3^Qov, Dd, Dd^Qov, Dd, Dd, Dd
Xzg3, Xzg3, Xzg3, Xzg3, Xzg3, Xzg3^Edp, Xzg3^Edp, Xzg3^Es, Rd, Xzg3, Xzg3, Xzg3, Xzg2^Qov, Xzg3, Xzg2^Qov, Xzg3, Xzg3, Xzg3^Qov, Xzg3^Qov, Xzg3^Qov, Xzg3^Qov, Xzg3^Qov, Xzg3, Xzg3^Edp, Xzg3, Xzg3^Qov, Xzg2^Ebn, Xzg2^Es, Rd, Rd, Xzg2, Xzg3, Xzg3^Es, Xzg3^Es, Xzg2^Qov, Xzg3, Xzg2^Qov, Xzg3, Xzg3, Rd, Xzg2, Xzg2^Qov, Xzg2^Qov, Xzg3^Qov, Xzg3^Qov, Xzg3^Qov, Xzg3^Qov, Dd
Dd^Qov, Dd^Qov, Dd^Qov, Dd^Qov, Xzg3, Xzg3^Edp, Xzg3^Edp, Rd, Xzg3^Es, Xzg3^Es, Xzg3, Xzg2^Qov, Xzg2^Edp, Xzg2^Qov, Xzg2^Edp, Xzg2^Qov, Xzg2^Qov, Xzg3, Xzg3, Xzg3^Es, Xzg3^Es, Xzg3^Es, Xzg3, Xzg2^Qov, Xzg2^Qov, Xzg2^Qov, Xzgg^Qov, Xzg2, Rd, Re, Xzg2, Xzg2^Qov, Xzg2^Qov, Xzg2^Qov, Xzg2^Edp, Xzg2, Xzgg^Qov, Xzg2^Qov, Xzg2^Qov, Rd, Xzg2, Xzg2^Edp, Xzg2, Xzg3^Qov, Xzg3^Edp, Xzg3^Edp, Xzg2, Xzg3^Qov
Xzg3^Qov, Dd^Qov, Xzg3^Qov, Xzg3^Qov, Xzg3^Edp, Xzg3^Edp, Xzg3^Edp, Xzg3^Edp, Rd, Xzg3^Es, Xzg3, Xzg2^Qov, Xzg2^Qov, Xzg2^Edp, Xzg2^Edp, Xzg2^Edp, Xzg2^Edp, Xzg2^Qov, Xzg3, Xzg3^Edp, Xzg3, Xzg3, Xzg3, Xzg3, Xzg2^Qov, Xzgg^Qov, Xzgg^Edp, Xzgg^Qov, Xzgg, Re, Xzgg^Qov, Xzgg^Qov, Xzgg^Qov, Xzg2, Xzgg^Qov, Xzgg^Qov, Xzgg^Es, Xzgg^Qov, Xzgg^Qov, Xzg2, Xzgg^Qov, Xzg2, Xzgg^Qov, Xzg2^Qov, Xzg3^Edp, Xzg2, Xzg2, Xzg2
Xzg3, Xzg3^Qov, Xzg3, Xzg3^Es, Xzg3, Xzg3^Edp, Xzg3, Xzg3^Edp, Xzg3, Xzg3^Es, Xzg3^Es, Xzg3, Xzg2^Qov, Xzg2^Edp, Xzg2^Qov, Xzg2^Edp, Xzg2, Xzg2^Qov, Xzg2^Qov, Xzg2^Qov, Xzg2^Qov, Xzg2^Qov, Xzg2^Qov, Xzg2^Qov, Xzg2^Qov, Xzgg^Qov, Xzgg^Edp, Xzgg^Edp, Rd, Re, Xzgg, Xzgg^Es, Xzgg^Es, Xzgg^Qov, Xzgg, Xzgg^Es, Xzgg, Xzgg, Xzg^Qov, Xzgg^Qov, Xzgg, Xzgg^Qov, Xzgg, Xzg2, Xzg2, Xzg3^Edp, Xzg3, Xzg3
Xzg3, Xzg3, Xzg3, Xzg3, Dd^Qov, Xzg3, Xzg3, Xzg3, Dd^Qov, Xzg3, Rd, Xzg3^Edp, Xzg3, Xzg2^Qov, Xzg3, Xzg2^Qov, Xzg2^Qov, Xzg2, Xzg2, Xzg2, Xzg3, Xzg2, Xzg2, Xzg2, Xzg2, Xzg2^Qov, Xzgg^Qov, Xzgg, Xzgg, Rd, Xzgg, Xzgg^Es, Xzgg, Xzgg^Ebn, Xzg^Qov, Xzgg, Xzg^Qov, Xzg^Qov, Xzg, Xzg^Qov, Xzg^Qov, Xzgg, Xzgg^Es, Xzgg, Xzgg, Xzg2, Xzg2, Xzg2
Rd, Xzg3^Edp, Xzg3, Dd^Qov, Dd^Es, Dd^Qov, Xzg3, Xzg3, Xzg3^Qov, Dd^Qov, Xzg3, Rd, Xzg3^Edp, Xzg3, Xzg3^Edp, Xzg3, Xzg3, Xzg2^Qov, Xzg2, Xzg2, Xzg2, Xzg3, Xzg3, Xzg2, Xzg2, Xzgg^Qov, Xzgg, Rd, Xzgg, Xzgg, Rd, Re, Rd, Xzg^Qov, Xzg, Xzg^Qov, Xzg^Edp, Xzg^Edp, Xzg^Edp, Xzg^Edp, Xzg^Qov, Xzgg, Xzg^Qov, Xzgg^Es, Xzgg^Es, Xzgg, Xzgg, Xzgg
Xzg3^Es, Xzg3^Edp, Xzg3, Dd^Qov, Dd^Qov, Dd^Qov, Xzg3, Xzg3^Edp, Xzg3^Es, Xzg3^Qov, Xzg3, Rd, Rd, 4 Rd, Xzg3^Edp, Xzg3^Edp, Xzg3, Xzg2^Qov, Xzg2^Es, Xzg2, Xzg3, Xzg3^Edp, Xzg2, Xzg2, Xzg2, Xzg2^Qov, Xzgg, Xzgg, Xzgg, Xzgg, Xzgg, Re, Re, Xzg, Rd, Xzg, Xzg, Xzg^Edp, Xzg^Vdt, Xzg^Edp, Xzg, Xzg^Qov, Xzg, Xzg^Qov, Xzgg, Xzgg, Xzgg, Xzgg
Xzg3, Xzg3, Xzg3, Xzg3^Qov, Xzg3^Qov, Xzg3^Qov, Xzg3^Es, Xzg3^Edp, Xzg3^Edp, Xzg3, Dd^Qov, Xzg3, Xzg3, Rd, Xzg3, Xzg3, Xzg2^Qov, Xzg2^Qov, Xzg2^Es, Xzg2, Xzg2, Xzg3, Xzg2, Xzg2, Xzgg^Qov, Xzgg^Qov, Xzgg, Xzg^Qov, Xzg^Qov, Xzg^Qov, Xzg^Qov, Xzg, Xzg, Rd, Rd, Xzg, Xzg, Xzg, Xzg, Xzg, Xzg^Vdt, Xzg, Xzg, Xzg^Qov, Xzg^Qov, Xzgg^Qov, Xzg^Qov, Xzg^Qov
Xzg2^Qov, Xzg3, Xzg2^Qov, Xzg2^Qov, Xzg3^Es, Xzg3^Es, Xzg3, Xzg3, Xzg3, Xzg3, Xzg3^Qov, Dd^Qov, Xzg3, Xzg3^Edp, Xzg3, Xzg2^Qov, Xzg2, Xzg2, Xzg2^Qov, Xzg2^Es, Xzg2^Es, Xzg2, Xzg3, Xzg2^Qov, Xzgg, Xzgg, Xzg^Qov, Xzg^Qov, Xzg, Xzg^Edp, Xzg^Es, Xzg, Xzg, Xzg, Xzg, Xzg, Xzg, Xzg, Xzg^Edp, Xzg, Xzg, Xzg^Es, Xzg^Edp, Xzg^Edp, Xzg, Xzg^Qov, Xzg, Xzg
Xzg2, Xzg2^Qov, Xzg2^Qov, Xzg2^Qov, Xzg3, Xzg3^Es, Dd^Qov, Dd^Qov, Dd^Qov, Xzg3, Xzg3, Xzg3^Qov, Xzg2^Qov, Xzg3, Xzg3, Xzg2^Qov, Xzg2^Qov, Xzg2^Qov, Xzg3, Xzg2^Qov, Xzg2^Es, Xzg2^Es, Xzg2, Xzg2^Qov, Xzgg, Xzgg, Xzgg, Xzg^Qov, Xzg^Qov, Xzg^Edp, Xzg^Vdt, Xzg^Es, Xzg, Xzg^Edp, Xzg, Xzg, Rd, Xzg, Rd, Xzg, Xzg, Xzg^Edp, Xzg^Es, Xzg^Edp, Xzg^Edp, Xzg^Es, Xzg^Es, Xzg
Xzg2^Edp, Xzg2^Edp, Xzg2^Qov, Xzg3, Xzg3, Dd^Qov, Dd, Dd^Es, Dd^Qov, Xzg3, Xzg2^Qov, Xzg2^Qov, Xzg3, Xzg3, Xzg3, Xzg3^Es, Xzg3^Es, Xzg3, Xzg3^Es, Xzg2^Qov, Xzg2^Qov, Xzg2, Xzg2^Qov, Xzg2^Qov, Xzg2^Qov, Xzgg, Xzgg^Es, Xzgg, Xzg^Qov, Xzg^Edp, Xzg^Edp, Xzg^Es, Xzg, Xzg^Edp, Xzg, Rd, Rd, 1 Re, Rd, Xzg, Xzg, Xzg, Xzg, Xzg^Edp, Xzg, Xzg, Xzg^Edp, Xzg
Xzg2, Xzg2^Edp, Xzg2^Edp, Xzg2^Qov, Xzg3, Dd^Qov, Dd^Qov, Dd^Qov, Xzg3^Qov, Xzg3, Xzg3, Xzg2^Qov, Xzg3, Dd^Qov, Xzg3, Xzg3, Dd^Qov, Xzg3^Es, Xzg3^Es, Xzg3, Xzg3, Xzg2^Qov, Xzg3, Xzg3, Xzg2^Qov, Xzgg^Qov, Xzgg^Es, Xzgg^Es, Xzg^Qov, Xzg^Edp, Xzg^Edp, Xzg^Es, Xzg^Es, Xzg^Es, Xzg, Xzg, Re, Re, Re, Xzg, Re, Xzg, Xzg, Xzg^Edp, Xzg, Xzg^Edp, Xzg, Xzg
Xzg2, Xzg2^Edp, Xzg2^Edp, Xzg2^Qov, Xzg3, Xzg3^Qov, Xzg3^Qov, Xzg3^Qov, Xzg3, Xzg3, Xzg3, Xzg2^Qov, Xzg3, Xzg3^Qov, Xzg3, Xzg3, Xzg3, Xzg3, Xzg3^Es, Xzg3^Es, Xzg3, Xzg3, Xzg3, Xzg3, Xzg2^Qov, Xzgg^Qov, Xzgg, Xzgg, Xzg^Qov, Xzg, Xzg, Xzg, Xzg, Xzg, Xzg, Xzg, Xzg, Re, Rd, Re, Re, Rd, Xzg, Xzg, Xzg, Xzg, Xzg, Xzg
