Xu, Xu, Xu, Xu, Dd, Xu, Xzg5^Qov, Xzg5, Ds, Wwg, Wo, Wo, Ds, Xzg5^Qov, Xzg5^Qov, Xu, Dd, Dd, Xu, Xu, Xu, Xu, Xu, Xu, Xu, Xu, Xu, Xu, Xu, Xu, Xu, Xu, Xu, Xu, Xu, Xu, Xu, Xu, Xu, Xu, Xu, Xu, Xu, Xos, Xos, Xos, Xos, Xos, Xos, Xos, Xos, Xos, Xos, Xos, Xos, Xos, Xos, Xos, Xos, Xos, Xos, Xos, Xos, Xos, Xos, Xos, Xos, Xos, Xos, Xos, Xos, Xos, Xos, Xos, Xos, Xos, Xos, Xos, Xos, Xos, Xos, Xos, Xos, Xos, Xos, Xos, Xos, Xos, Xos, Xos, Xos, Xos
Xu, Xu, Xu, Xu, Xu, Dd, Xu, Xzg5^Qov, Ds, Wo, Wwg, Wo, Wwg, Ds, Ds, Xzg5^Qov, Xzg5^Qov, Dd^Es, Dd, Xu, Xu, Xu, Xu, Xu, Xu, Xu, Xu, Xu, Xu, Xu, Xu, Xu, Xu, Xu, Xu, Xu, Xu, Xu, Xu, Xu, Xu, Xu, Xos, Xos, Xos, Xos, Xos, Xos, Xos, Xos, Xos, Xos, Xos, Xos, Xos, Xos, Xos, Xos, Xos, Xos, Xos, Xos, Xos, Xos, Xos, Xos, Xos, Xos, Xos, Xos, Xos, Xos, Xos, Xos, Xos, Xos, Xos, Xos, Xos, Xos, Xos, Xos, Xos, Xos, Iwr, Xos, Xos, Xos, Xos, Xos, Xos, Xos
Xu, Xu, Xu, Xu, Xu, Dd, Dd, Xzg5^Qov, Xzg5^Qov, Ds, Ds, Wwg, Ds, Ds, Ds, Ds, Xzg5, Xzg5^Qov, Dd, Xu, Xu, Xu, Xu, Xu, Xu, Xu, Xu, Xu, Xu, Xu, Xu, Xu, Xu, Xu, Xu, Xu, Xu, Xu, Xu, Xu, Xu, Xu, Xos, Xos, Xos, Xos, Xos, Xos, Xos, Xos, Xos, Xos, Xos, Xos, Xos, Xos, Xos, Xos, Xos, Xos, Xos, Xos, Xos, Xos, Xos, Xos, Xos, Xos, Xos, Xos, Xos, Xos, Xos, Xos, Xos, Xos, Xos, Xos, Xos, Xos, Xos, Xos, Iwr^Ebn, Iwr, Iwr, Iwr, Iwr^Ebn, Xos, Xos, Xos, Xos, Xos
Xu, Xu, Xu, Xu, Xu, Xu, Xu, Dd, Xu, Xzg5^Qov, Xzg5, Ds, Ds, Ds^Es, Ss, Ds, Ds, Xzg5^Qov, Xzg5^Qov, Dd, Xu, Xu, Xu, Xu, Xu, Xu, Xu, Xu, Xu, Xu, Xu, Xu, Xu, Xu, Xu, Xu, Xu, Xu, Xu, Xu, Xu, Xu, Xu, Xos, Xos, Xos, Xos, Xos, Xos, Xos, Xos, Xos, Xos, Xos, Xos, Xos, Xos, Xos, Xos, Xos, Xos, Xos, Xos, Xos, Xos, Xos, Xos, Xos, Xos, Xos, Xos, Xos, Xos, Xos, Xos, Xos, Xos, Xos, Xos, Xos, Iwr, Iwr, Iwr, Iwr, Wo, Iwr^Cov, 2 Iwr^Kov, Iwr, Iwr^Ebn, Xos, Xos, Xos
Xu, Xu, Xu, Xu, Xu, Xu, Xu, Dd^Es, Xu, Xzg5^Qov, Ds, Ds, Ss, Wwf, Wwf, Ss, Ss, Ds, Xzg5^Qov, Dd, Rd, Xu, Xu, Xu, Xu, Xu, Xu, Xu, Xu, Xu, Xu, Xu, Xu, Xu, Xu, Xu, Xu, Xu, Xu, Xu, Xu, Xu, Xu, Xu, Xos, Xos, Xos, Xos, Xos, Xos, Xos, Xos, Xos, Xos, Xos, Xos, Xos, Xos, Xos, Xos, Xos, Xos, Xos, Xos, Xos, Xos, Xos, Xos, Xos, Xos, Xos, Xos, Xos, Xos, Xos, Xos, Xos, Xos, Iwr, Iwr^Ebn, Iwr, Iwr, Wo, Wo, 8 Iwr, Wo, Wo, Iwr^Cov, Iwr, Iwr, Iwr, Xos
Xu, Xu, Xu, Xu, Xu, Xu, Dd, Dd^Es, Xzg5^Qov, Xzg5^Qov, Ds, Ss, Ds, Wwf, Wwf, Ds, Ss, Ds, Xzg5^Qov, Xu, Xu, Rd, Xu, Xu, Xu, Xu, Xu, Xu, Xu, Xu, Xu, Xu, Xu, Xu, Xu, Xu, Xu, Xu, Xu, Xu, Xu, Xu, Xu, Xu, Xu, Xos, Xos, Xos, Xos, Xos, Xos, Xos, Xos, Xos, Xos, Xos, Xos, Xos, Xos, Xos, Xos, Xos, Xos, Xos, Xos, Xos, Xos, Xos, Xos, Xos, Xos, Xos, Xos, Xos, Xos, Xos, Iwr^Ebn, Iwr, Iwr, Iwr, Wo, Wo, Wo, Wo, Wo, Wo, Iwr, Iwr, Iwr^Ebn, Iwr, Xos, Xos
Xu, Xu, Xu, Xu, Xu, Xu, Xu, Dd, Xu, Xzg5^Qov, Xzg5^Qov, Ds, Xzg5^Es, Rd, Ds, Ss, Ss, Ds, Xzg5^Qov, Dd, Dd, Rd, Xu, Xu, Xu, Xu, Xu, Xu, Xu, Xu, Xu, Xu, Xu, Xu, Xu, Xu, Xu, Xu, Xu, Xu, Xu, Xu, Xu, Xu, Xu, Xos, Xos, Xos, Xos, Xos, Xos, Xos, Xos, Xos, Xos, Xos, Xos, Xos, Xos, Xos, Xos, Xos, Xos, Xos, Xos, Xos, Xos, Xos, Xos, Xos, Xos, Xos, Xos, Xos, Iwr, Iwr, Iwr, Iwr, Wo, Wo, Wo, Wo, Wo, Wo, Iwr, Iwr, Iwr, Iwr, Xos, Xos, Xos, Xos
Xu, Xu, Xu, Xu, Xu, Xu, Xu, Rd, Rd, Dd^Vdt, Xu, Xzg5, Re, Rd, Ds, Ds, Ds^Es, Ds, Ds, Xzg5^Qov, Dd, Dd, Xu, Xu, Xu, Xu, Xu, Xu, Xu, Xu, Xu, Xu, Xu, Xu, Xu, Xu, Xu, Xu, Xu, Xu, Xu, Xu, Xu, Xu, Xu, Xos, Xos, Xos, Xos, Xos, Xos, Xos, Xos, Xos, Xos, Xos, Xos, Xos, Xos, Xos, Xos, Xos, Iwr, Iwr, Iwr, Xos, Xos, Xos, Xos, Xos, Xos, Xos, Xos, Xos, Xos, Iwr, Iwr, Iwr, Iwr, Wo, Wo, Wo, Iwr, Iwr, Iwr, Iwr^Ebn, Xos, Xos, Xos, Xos, Xos, Xos
Xu, Xu, Xu, Xu, Xu, Xu, Xu, Xu, Xu, Rd, Dd, Dd, Dd, Xzg5, Xzg5^Qov, Ds, Ds^Es, Ss, Ds, Rd, Re, Re, Rd, Xu, Xu, Xu, Xu, Xu, Xu, Xu, Xu, Xu, Xu, Xu, Xu, Xu, Xu, Xu, Xu, Xu, Xu, Xu, Xu, Xu, Xu, Xos, Xos, Xos, Xos, Xos, Xos, Xos, Xos, Xos, Xos, Xos, Xos, Xos, Xos, Xos, Iwr^Qov, Iwr^Qov, Iwr, Iwr, Iwr, Iwr, Iwr, Xos, Xos, Xos, Iwr^Qov, Iwr^Ebn, Iwr, Xos, Xos, Xos, Iwr, Iwr, Iwr, Iwr, Iwr, Iwr, Iwr^Ebn, Iwr, Xos, Xos, Xos, Xos, Xos, Xos, Xos, Xos
Xu, Xu, Xu, Xu, Xu, Xu, Xu, Xu, Xu, Xu, Xu, Dd, Dd, Xu, Xzg5^Qov, Xzg5, Ds, Ds^Es, Rd, Re, Ds, Xu, Xu, Dd, Xu, Xu, Xu, Xu, Xu, Xu, Xu, Xu, Dd, Dd, Dd, Xu, Xu, Xu, Xu, Xu, Xu, Xu, Xos, Xu, Xos, Xos, Xos, Xos, Xos, Xos, Xos, Xos, Xos, Xos, Xos, Xos, Xos, Xos, Iwr, Iwr, Iwr, Iwr, Iwr, Iwr, Xos, Xos, Xos, Iwr, Iwr, Iwr^Qov, Iwr^Qov, Iwr, Iwr, Xos, Iwr, Iwr, Xos, Xos, Xos, Iwr, Iwr, Iwr, Xos, Xos, Xos, Xos, Xos, Xos, Xos, Xos, Xos, Xos
Xu, Xu, Xu, Xu, Xu, Xu, Xu, Xu, Xu, Xu, Xu, Dd, Xu, Xu, Xzg5^Qov, Ds, Ss, Ss, Rd, Xzg5^Es, Ds^Es, Xzg5^Qov, Xzg5^Qov, Dd, Dd, Xu, Xu, Xu, Dd, Dd, Dd, Xu, Rd^Es, Rd^Es, Dd, Xu, Xu, Xu, Xos, Xos, Xos, Xos, Xos, Xos, Xos, Xos, Xos, Xos, Xos, Xos, Xos, Xos, Xos, Xos, Xos, Xos, Iwr, Iwr, Iwr, Iwr, Iwr, Iwr^Ebn, Xos, Xos, Xos, Xos, Iwr, Iwr, Iwr, Iwr^Qov, Wo, Iwr^Qov, Iwr, Iwr, Iwr, Xos, Iwr, Xos, Xos, Xos, Xos, Xos, Xos, Xos, Xos, Xos, Xos, Xos, Xos, Xos, Xos, Xos
Xu, Xu, Xu, Xu, Xu, Xu, Xu, Xu, Xu, Xu, Xu, Re, Rd, Xu, Xzg5^Qov, Ds, Ds, Ss, Wwf, Ds, Ss, Ds, Xzg5^Qov, Xu, Dd^Vdt, Dd, Dd, Dd, Xu, Xu, Xu, Rd, Rd, Dd, Dd, Xu, Xos, Xos, Xos, Xos, Xos, Xos, Xos, Xos, Xos, Xos, Xos, Xos, Xos, Xos, Xos, Xos, Xos, Xos, Xos, Iwr^Qov, Iwr, Iwr, Iwr, Iwr, Xos, Xos, Xos, Xos, Xos, Iwr^Ebn, Iwr, Iwr, Wo, Wo, Wo, Wo, Wo, Iwr, Iwr, Iwr^Qov, Iwr, Iwr, Iwr^Ebn, Xos, Xos, Xos, Xos, Xos, Xos, Xos, Xos, Xos, Xos, Xos, Xos, Xos
Xu, Xu, Xu, Xu, Xu, Xu, Xu, Xu, Xu, Xu, Xu, Xu, Xu, Dd, Dd, Xzg5^Qov, Xzg5^Qov, Ds, Ds, Wwf, Ss, Ds, Xzg5, Xzg5^Qov, Xu, Rd, Re, Xu, Xu, Xu, Xu, Dd, Xu, Dd, Xos, Xos, Iwr^Qov, Xos, Xos, Xos, Xos, Xos, Xos, Xos, Xos, Xos, Xos, Xos, Xos, Xos, Xos, Xos, Xos, Xos, Xos, Xos, Xos, Iwr^Qov, Xos, Iwr, Iwr, Xos, Iwr, Xos, Xos, Xos, Xos, Iwr, Iwr, Wo, Wo, Wo, Wo, Wo, Iwr, Iwr, Iwr, Iwr, Xos, Xos, Xos, Xos, Xos, Xos, Xos, Xos, Xos, Xos, Xos, Xos, Xos, Xos
Xu, Xu, Xu, Xu, Xu, Xu, Xu, Xu, Xu, Xu, Xu, Xu, Xu, Xu, Rd, Xu, Xzg5^Qov, Ds, Ss, Ss, Wwf, Ds, Ds, Xzg5^Qov, Xzg5^Qov, Xu, Xu, Re, Xu, Xu, Xu, Xu, Xu, Xos, Iwr^Qov, Iwr, Iwr, Iwr^Qov, Iwr, Iwr, Iwr^Qov, Xos, Xos, Xos, Xos, Xos, Xos, Xos, Xos, Xos, Xos, Xos, Xos, Xos, Xos, Xos, Xos, Xos, Xos, Xos, Iwr, Iwr, Iwr, Iwr^Ebn, Iwr^Qov, Xos, Xos, Xos, Xos, Iwr, Iwr, Wo, Iwr, Iwr, Iwr^Qov, Iwr, Iwr, Xos, Xos, Xos, Xos, Xos, Xos, Xos, Xos, Xos, Xos, Xos, Xos, Xos, Xos, Xos
Xu, Xu, Xu, Xu, Xu, Xu, Xu, Xu, Xu, Xu, Xu, Xu, Xu, Re, Rd, Xu, Xzg5^Qov, Ds, Ds, Wwf, Wwf, Ss, Ss, Ds, Xzg5^Qov, Xzg5^Qov, Dd, Dd, Xu, Xu, Xu, Xu, Xos, Xos, Xos, Iwr, Iwr, Iwr, Iwr, Iwr, Iwr, Iwr^Ebn, Iwr, Xos, Xos, Xos, Xos, Xos, Xos, Xos, Xos, Xos, Iwr^Qov, Iwr^Ebn, Iwr, Xos, Xos, Xos, Iwr^Qov, Iwr, Iwr, Iwr, Iwr, Iwr, Iwr, Xos, Xos, Xos, Xos, Xos, Xos, Iwr, Iwr^Ebn, Iwr^Qov, Xos, Xos, Xos, Iwr, Iwr, Xos, Xos, Xos, Xos, Xos, Xos, Xos, Xos, Xos, Xos, Xos, Xos, Xos
Xu, Xu, Xu, Xu, Xu, Xu, Xu, Xu, Xu, Dd^Vdt, Dd, Xu, Xu, Xu, Xu, Dd^Es, Xu, Xzg5^Qov, Ds^Es, Ds, Ds, Wwf, Ds, Ds, Xzg5^Qov, Dd, Xu, Xu, Xu, Xu, Xu, Xu, Xos, Xos, Xos, Iwr, Iwr, Iwr, Iwr, Iwr, Iwr, Iwr, Xos, Xos, Xos, Xos, Iwr, Iwr^Ebn, Iwr, Xos, Xos, Xos, Xos, Iwr, Iwr, Iwr, Iwr, Xos, Xos, Iwr, Iwr, Iwr, Iwr^Qov, Iwr, Iwr, Iwr^Ebn, Iwr, Xos, Iwr^Qov, Xos, Xos, Xos, Xos, Xos, Xos, Xos, Iwr, Iwr, Iwr, Iwr, Iwr^Qov, Xos, Xos, Xos, Xos, Xos, Xos, Xos, Xos, Xos, Xos, Xos
Xu, Xu, Xu, Xu, Xu, Xu, Xu, Xu, Dd, Dd, Ce, Dd, Rd, Xu, Xu, Rd^Es, Dd^Es, Xzg5^Qov, Xzg5^Qov, Xzg5^Es, Ds, Wwf, Wwf, Ds, Xzg5^Qov, Dd, Xu, Xu, Xu, Xu, Xu, Xu, Xu, Xos, Xos, Xos, Xos, Iwr^Ebn, Iwr^Qov, Iwr, Xos, Iwr, Iwr, Xos, Iwr, Iwr, Iwr, Iwr, Iwr, Iwr, Iwr, Xos, Iwr, Iwr, Xos, Iwr, Iwr, Iwr, Iwr, Iwr, Xos, Xos, Xos, Iwr^Qov, Iwr, Iwr, Iwr, Iwr, Iwr, Iwr^Ebn, Iwr, Xos, Xos, Xos, Iwr^Ebn, Iwr, Iwr, Iwr, Iwr, Iwr^Qov, Xos, Xos, Xos, Xos, Xos, Xos, Xos, Xos, Xos, Xos, Xos, Xos
Xu, Xu, Xu, Xu, Xu, Xu, Xu, Xu, Rd, Ce, 4 Ket, Ce, Rd, Xu, Rd, Xu, Rd^Es, Dd^Es, Xzg5^Qov, Xzg5^Edb, Ds^Edb, Ss, Ds, Ds, Xzg5^Qov, Dd, Rd, Xu, Xu, Xu, Xu, Xu, Xu, Xu, Xu, Xos, Xos, Xos, Xos, Xos, Xos, Xos, Iwr, Iwr, Iwr, Iwr, Iwr, Iwr, Iwr, Iwr, Iwr, Iwr, Iwr, Xos, Xos, Xos, Xos, Iwr, Iwr, Iwr, Iwr^Qov, Xos, Xos, Xos, Iwr, Iwr, Iwr, Iwr, Iwr, Iwr, Iwr, Xos, Iwr^Qov, Iwr^Qov, Iwr, Iwr, Iwr, Iwr, Xos, Xos, Xos, Xos, Xos, Xos, Xos, Xos, Xos, Xos, Xos, Xos, Xos, Xos
Xu, Xu, Xu, Xu, Xu, Xu, Xu, Dd, Dd, Ce, Ce, Ce, Rd, Rd, Xu, Rd, Xu, Dd, Xzg5^Qov, Ds^Edb, Ds^Edb, Ds^Edb, Ds, Xzg5^Qov, Xu, Dd, Xu, Xu, Xu, Xu, Xu, Xu, Xu, Xu, Xos, Xu, Xos, Xos, Xos, Xos, Iwr, Iwr, Wo, Iwr, Iwr^Qov, Iwr, Iwr, Iwr, Iwr, Iwr, Wo, Wo, Wo, Iwr, Iwr, Xos, Xos, Xos, Xos, Iwr, Iwr, Iwr, Iwr, Iwr, Xos, Iwr, Iwr^Qov, Iwr^Qov, Xos, Xos, Iwr, Iwr, Iwr, Iwr, Iwr, Iwr, Xos, Xos, Xos, Xos, Xos, Xos, Xos, Xos, Xos, Xos, Xos, Xos, Xos, Xos, Xos, Xos
Xu, Xu, Xu, Xu, Xu, Xu, Xu, Xu, Dd^Vdt, Rd, Rd, Rd, Xu, Rd, Rd, Xu, Xu, Dd, Dd, Xzg5^Qov, Ds^Edb, Ds^Es, Ds, Xzg5^Qov, Xzg5^Qov, Dd, Dd, Xu, Rd, Xu, Xu, Xu, Xu, Xu, Xos, Xos, Xos, Xos, Xos, Iwr, Iwr, Wo, Wo, Wo, Wo, Iwr^Qov, Iwr, Iwr^Qov, Iwr, Iwr^Qov, Iwr^Qov, Wo, Wo, Wo, Wo, Iwr, Iwr, Xos, Xos, Xos, Xos, Iwr, Iwr, Iwr, Iwr, Xos, Xos, Xos, Xos, Xos, Xos, Iwr, Iwr, Iwr, Xos, Xos, Xos, Xos, Xos, Xos, Xos, Xos, Xos, Xos, Xos, Xos, Xos, Xos, Xos, Xos, Xos, Xos
Xu, Xu, Xu, Xu, Xu, Xu, Xu, Xu, Xu, Xu, Xu, Xu, Xu, Xu, Xu, Dd, Xu, Dd, Xzg5^Qov, Xzg5^Qov, Ds, Ds^Edb, Ss, Ds, Ds, Xzg5^Qov, Xzg5^Qov, Dd, Dd, Rd, Xu, Xu, Xu, Xu, Xos, Xu, Xos, Xos, Xos, Xos, Xos, Iwr, Iwr, Wo, Iwr, Iwr, Iwr, Iwr, Iwr, Iwr^Qov, Iwr^Qov, Iwr^Qov, Iwr, Wo, Wo, Wo, Wo, Iwr, Iwr, Xos, Xos, Xos, Xos, Iwr, Iwr, Iwr, Iwr, Xos, Xos, Xos, Xos, Xos, Xos, Xos, Xos, Xos, Xos, Xos, Xos, Xos, Xos, Xos, Xos, Xos, Xos, Xos, Xos, Xos, Xos, Xos, Xos, Xos
Xu, Xu, Xu, Xu, Xu, Xu, Xu, Xu, Xu, Xu, Xu, Xu, Xu, Xu, Xu, Dd, Dd^Es, Dd^Es, Dd, Xzg5^Qov, Xzg5^Qov, Ds, Ds, Wwf, Ss, Ds, Ds, Xzg5^Qov, Xu, Rd, Xu, Xu, Xu, Xu, Xu, Xu, Xu, Xos, Xos, Xos, Xos, Xos, Xos, Iwr, Iwr, Iwr, Iwr, Iwr, Iwr, Iwr, Iwr, Iwr, Iwr, Iwr, Iwr, Wo, Wo, Wo, Wo, Iwr, Iwr, Xos, Xos, Xos, Iwr, Iwr, Iwr, Iwr, Iwr^Ebn, Xos, Xos, Xos, Xos, Xos, Xos, Xos, Xos, Xos, Xos, Xos, Xos, Xos, Xos, Xos, Xos, Xos, Xos, Xos, Xos, Xos, Xos, Xos
Xu, Xu, Xu, Xu, Xu, Xu, Xu, Xu, Xu, Xu, Xu, Xu, Xu, Xu, Xuc, Xu, Dd, Dd, Rd, Dd, Dd, Xzg5^Qov, Xzg5^Qov, Ds, Ds, Ds, Ds, Xzg5^Qov, Xu, Rd, Xu, Xu, Xu, Xu, Xu, Xu, Xu, Xu, Xos, Xos, Xos, Xos, Xos, Xos, Xos, Iwr, Iwr, Iwr, Iwr, Iwr, Iwr, Iwr, Iwr, Iwr, Iwr, Iwr, Iwr, Wo, Wo, Wo, Wo, Iwr, Iwr, Iwr, Xos, Xos, Xos, Iwr, Xos, Xos, Xos, Xos, Xos, Xos, Xos, Xos, Xos, Xos, Xos, Xos, Xos, Xos, Xos, Xos, Xos, Xos, Xos, Xos, Xos, Xos, Xos, Xos
Xu, Xu, Xu, Xu, Xu, Xu, Xu, Xu, Xu, Xuc, Xuc, Xuc, Xuc, Xuc, Rd, Dd, Dd, Xu, Rd, Xu, Dd, Xu, Xzg5^Qov, Xzg5^Es, Ds^Es, Ds^Es, Xzg5, Xzg5^Qov, Dd, Dd, Xu, Xu, Xu, Xu, Xu, Xu, Xu, Xos, Xos, Xos, Xos, Xos, Xos, Xos, Xos, Xos, Xos, Iwr, Iwr, Iwr, Iwr, Iwr, Iwr, Iwr, Iwr, Iwr, Iwr, Iwr, Iwr, Wo, Iwr, Iwr, Iwr, Iwr, Iwr, Xos, Xos, Xos, Xos, Xos, Xos, Xos, Xos, Xos, Xos, Xos, Xos, Xos, Xos, Xos, Xos, Xos, Xos, Xos, Xu, Xos, Xu, Xos, Xos, Xos, Xos, Xos
Xu, Xu, Xuc, Xu, Xu, Xu, Xu, Xu, Dd, Rd, Rd, Rd, Rd, Rd, Xuc, Xuc, Xu, Xu, Xu, Rd, Rd, Dd, Rd, Ds, Ss, Ds, Ds, Xzg5^Qov, Xzg5^Qov, Dd, Xu, Xu, Xu, Xu, Xu, Xu, Xu, Xos, Xos, Xos, Xos, Xos, Iwr^Ebn, Iwr^Qov, Iwr^Qov, Xos, Iwr, Iwr, Xos, Iwr, Iwr, Iwr, Iwr, Iwr, Iwr^Qov, Iwr, Iwr, Iwr, Iwr, Iwr, Iwr, Iwr^Qov, Iwr^Qov, Iwr, Iwr, Iwr, Iwr^Ebn, Xos, Xos, Xos, Xos, Xos, Xos, Xos, Xos, Xos, Xos, Xos, Xos, Xos, Xos, Xos, Xu, Xu, Xu, Xu, Xu, Xu, Xu, Xu, Xu, Xu
Dd, Dd, Dd, Xuc, Dd^Es, Xu, Xu, Dd, Xuc, Xu, Xu, Xu, Xu, Xuc, Xu, Xu, Xu, Xu, Xu, Xu, Dd, Re, Re, Rd, Rd, Ss, Wwf, Ds, Xzg5^Qov, Dd, Xu, Xu, Xu, Xu, Xu, Xu, Xu, Xos, Xos, Xos, Iwr, Iwr, Iwr, Iwr, Iwr, Iwr, Iwr, Xos, Xos, Xos, Xos, Iwr, Iwr, Iwr^Qov, Iwr, Iwr, Iwr, Iwr, Iwr, Iwr, Iwr, Iwr, Iwr, Iwr, Iwr, Iwr, Xos, Xos, Xos, Xos, Xos, Xos, Xos, Xos, Xos, Xos, Xos, Xos, Xos, Xos, Xos, Xu, Xu, Xu, Xu, Xu, Xu, Xu, Xu, Xu, Xu, Xu
Xzg5^Qov, Dd, Xzg5^Qov, Dd, Dd, Dd, Dd, Dd, Dd, Xuc, Rd, Xu, Rd, Xu, Xu, Xu, Xu, Xu, Xu, Xu, Dd, Xzg5^Qov, Xzg5^Qov, Ds, Ds, Wwf, Wwf, Ds, Xzg5^Qov, Dd, Dd, Xu, Xu, Xu, Xu, Xu, Xu, Xu, Xu, Xos, Xos, Iwr^Qov, Iwr, Iwr, Iwr, Iwr, Iwr, Iwr, Iwr, Xos, Xos, Xos, Xos, Iwr, Iwr^Qov, Iwr, Wo, Wo, Wo, Iwr, Iwr, Iwr, Iwr, Iwr, Xos, Xos, Xos, Xos, Xos, Xos, Xos, Xos, Xos, Xos, Xos, Xos, Xos, Xos, Xos, Xos, Xu, Xu, Xu, Xu, Xu, Xu, Xu, Xu, Xu, Xu, Xu, Xu
Xzg5, Xzg5^Qov, Xzg5, Xzg5^Qov, Xzg5^Qov, Xzg5^Qov, Xzg5^Qov, Xzg5^Qov, Rd, Dd, Dd, Rd^Es, Xu, Xu, Xu, Xu, Xu, Xu, Xu, Xu, Dd, Dd, Dd, Xzg5^Qov, Xzg5^Qov, Ds, Ds^Es, Ds, Xzg5^Qov, Xu, Xu, Dd, Xu, Xu, Xu, Xu, Xu, Xu, Xos, Xos, Iwr^Qov, Iwr^Dr, Iwr, Iwr, Iwr, Iwr, Iwr^Qov, Iwr^Ebn, Xos, Xos, Xu, Xu, Xu, Xos, Xos, Iwr, Iwr, Wo, Wo, Wo, Iwr, Iwr, Xos, Iwr, Iwr, Xos, Iwr^Qov, Iwr, Iwr^Ebn, Xos, Xos, Xos, Xos, Xos, Xos, Xos, Xos, Xos, Xos, Xu, Xu, Xu, Xu, Xu, Xu, Xu, Xu, Xu, Xu, Xu, Xu, Xu
Xzg5^Qov, Xzg5, Ds, Xzg5, Ds, Ds, Ds, Rd, Xzg5^Es, Xzg5^Qov, Xzg5^Qov, Dd, Dd, Xuc, Xu, Xu, Xu, Xu, Xuc, Xuc, Xuc, Xu, Dd^Es, Dd^Es, Xzg5^Qov, Ds^Edb, Ds^Edb, Ds, Ds^Edb, Xzg5^Qov, Xzg5^Qov, Dd, Xu, Xu, Xu, Xu, Xu, Xu, Xu, Xos, Xos, Iwr^Dr, Iwr^Dr, Iwr, Xos, Iwr, Xos, Xos, Xu, Xu, Dd, Dd, Dd, Xu, Xu, Xos, Xos, Iwr, Iwr, Iwr, Xos, Xos, Xos, Xos, Iwr, Iwr, Iwr, Iwr, Iwr, Iwr^Qov, Iwr^Qov, Xos, Xos, Xos, Xos, Xos, Xos, Xos, Xu, Xu, Xu, Xu, Xu, Xu, Xu, Xu, Xu, Xu, Xu, Xu, Xu, Xu
Dd, Xzg5^Qov, Xzg5^Qov, Xzg5, Ds, Ss, Rd, Ds, Ds^Es, Ds, Ds, Xzg5^Qov, Dd, Xuc, Xuc, Xu, Xu, Xu, Xuc, Xuc, Rd, Dd, Dd^Vdt, Dd, Dd, Xzg5^Qov, Ds^Edb, Ds^Es, Ds^Edb, Xzg5, Rd, Dd, Rd, Dd, Dd, Dd^Dr, Dd, Dd^Dr, Dd^Dr, Xu, Xu, Xos, Xos, Xos, Xos, Xos, Xos, Xos, Xu, Dd, Ce, Ce, Ce, Dd^Vdt, Xu, Xos, Xos, Xos, Xos, Xos, Xos, Xos, Xos, Iwr, Iwr^Ebn, Iwr, Iwr, Iwr, Iwr, Iwr^Qov, Iwr, Xos, Xos, Xos, Xu, Xos, Xu, Xu, Xu, Xu, Xu, Xu, Xu, Xu, Xu, Xu, Xu, Xu, Xu, Xu, Xu, Xu
Xu, Dd, Dd, Xzg5^Qov, Ds, Ds, Rd, Ss, Ss, Ss, Ds, Xzg5^Qov, Xzg5^Qov, Dd, Dd, Xu, Xu, Xu, Xuc, Rd, Xuc, Xuc, Xu, Xu, Dd, Xzg5^Qov, Ds, Ds, Ss, Rd^Es, Ds^Es, Rd, Xzg5^Qov, Xu, Xzg5^Qov, Xu, Xu, Xu, Dd^Dr, Xu, Xu, Xu, Xu, Xu, Xu, Xos, Xu, Xu, Dd, Rd, Ce, 5 Ket, Ce, Rd, Rd, Xu, Xos, Xos, Xos, Xos, Xos, Xos, Xos, Xos, Xos, Iwr^Qov, Iwr^Qov, Iwr, Iwr, Iwr, Iwr, Iwr, Xos, Xu, Xu, Xu, Xu, Xu, Xu, Xu, Xu, Xu, Xu, Xu, Xu, Xu, Xu, Xu, Xu, Xu, Xu, Xu
Xu, Xu, Dd, Xzg5^Qov, Xzg5^Qov, Rd, Xzg5^Qov, Ds, Ss, Ss, Ss, Ds, Xzg5, Xzg5^Qov, Dd^Es, Xu, Xu, Xu, Re, Re, Xuc, Xu, Xu, Xu, Dd^Es, Xzg5^Qov, Ds, Ds, Ds^Es, Ds, Ss, Ds, Ds, Xzg5^Qov, Ds, Xzg5^Qov, Xzg5^Qov, Xu, Dd, Xu, Dd, Xu, Dd^Es, Xu, Rd^Es, Xu, Xu, Xu, Dd, Rd, Rd, Ce, Rd, Rd, Dd^Vdt, Xu, Xos, Xos, Xos, Xos, Xos, Xos, Xos, Xos, Xos, Xos, Xos, Xos, Xos, Iwr, Xos, Xos, Dd, Xu, Dd, Xu, Xu, Xu, Xu, Xu, Xu, Xu, Xu, Xu, Xu, Xu, Xu, Xu, Xu, Xu, Xu, Xu
Xu, Xu, Xuc, Dd, Dd^Es, Dd, Xzg5^Qov, Ds, Ss, Ss, Ds, Ds, Xzg5^Qov, Xzg5^Qov, Dd, Dd, Dd, Xu, Re, Xuc, Xuc, Xu, Xu, Dd, Dd, Xzg5^Qov, Xzg5^Qov, Xzg5, Ds, Ds^Es, Ds, Wwf, Wwf, Ds, Ss, Ds, Ds, Xzg5^Qov, Xzg5^Qov, Dd, Xzg5^Qov, Dd, Xzg5^Qov, Dd^Es, Dd^Es, Dd, Dd, Dd, Xu, Xu, Xu, Rd, Xu, Xu, Xu, Xu, Xu, Xos, Xos, Xos, Xos, Xos, Xos, Xos, Xos, Xos, Xos, Xos, Xos, Xos, Xu, Xu, Dd, Dd, Dd^Es, Dd^Es, Dd^Es, Xu, Xu, Xu, Xu, Xu, Xu, Xu, Xu, Xu, Xu, Xu, Xu, Xu, Xu, Xu
Xu, Xu, Xu, Xuc, Dd^Es, Xzg5^Qov, Ds, Ds, Ss, Ss, Ds, Xzg5^Qov, Dd, Dd^Es, Rd, Xu, Xu, Rd, Xuc, Xuc, Xu, Xu, Xu, Xu, Xu, Dd, Dd, Xzg5^Qov, Xzg5^Qov, Xzg5, Ds, Wwf, Ds, Ds, Ds, Ds, Ss, Ds, Ds, Xzg5^Qov, Xzg5, Xzg5^Qov, Xzg5, Xzg5^Qov, Xzg5^Qov, Xzg5^Qov, Xzg5^Qov, Dd, Dd, Xu, Xu, Rd, Xu, Xu, Xu, Xu, Xu, Xu, Xu, Xos, Xu, Xos, Xu, Xos, Xos, Xos, Xos, Xos, Xu, Xu, Xu, Xu, Dd, Rd, Rd, Rd, Rd, Xu, Xu, Xu, Xu, Xu, Xu, Xu, Xu, Xu, Xu, Xu, Xu, Xu, Xu, Xu
Xu, Xu, Xu, Xuc, Dd, Xzg5^Qov, Ds, Ss, Ss, Wwf, Ds, Xzg5^Qov, Dd, Dd^Es, Rd, Xu, Xu, Xu, Xu, Xu, Xu, Xu, Xu, Xu, Xu, Dd, Dd, Xu, Xu, Xzg5^Qov, Xzg5^Qov, Ds, Xzg5^Qov, Ds, Ds, Ss, Ss, Wwf, Wwf, Ds, Ds, Ds, Ds, Ds, Ds, Ds, Ds, Xzg5^Qov, Xzg5^Qov, Dd, Dd, Rd, Dd, Xu, Dd, Rd, Rd, Xu, Xu, Xu, Xu, Xu, Xu, Xu, Xu, Xu, Xu, Xu, Xu, Xu, Xu, Xu, Xu, Rd, Dd, Xu, Xu, Xu, Xu, Xu, Xu, Xu, Xu, Xu, Xu, Xu, Xu, Xu, Xu, Xu, Xu, Xu
Xu, Xu, Xu, Xu, Dd, Xzg5^Qov, Xzg5^Qov, Ds, Rd, Wwf, Ds, Xzg5^Qov, Xzg5^Qov, Dd, Xuc, Re, Re, Xu, Xu, Xu, Xu, Xu, Xu, Xu, Xu, Xu, Xu, Dd, Dd, Dd, Dd, Xzg5^Qov, Dd, Xzg5^Qov, Xzg5^Qov, Ds, Ds, Wwf, Ss, Ds^Es, Ds^Es, Ss, Wwf, Wwf, Ss, Ss, Wwf, Ds, Xzg5^Qov, Xu, Ds, Rd, Ds, Dd, Xzg5^Qov, Xu, Xu, Rd, Xu, Xu, Xu, Xu, Xu, Xu, Xu, Xu, Xu, Xu, Xu, Xu, Xu, Xu, Xu, Rd, Dd, Xu, Xu, Xu, Xu, Xu, Xu, Xu, Xu, Xu, Xu, Xu, Xu, Xu, Xu, Xu, Xu, Xu
Xu, Xu, Dd, Xu, Rd, Dd, Dd, Rd, Ds, Wwf, Ss, Ds, Xzg5^Qov, Dd, Dd, Rd, Re, Xu, Xu, Xu, Xu, Xu, Xu, Xu, Xu, Xu, Xu, Dd, Dd, Xu, Dd^Vdt, Dd, Dd, Dd, Dd, Xzg5^Qov, Xzg5^Qov, Ds, Ds, Ss, Ds, Ss, Ds, Ds, Ss, Wwf, Wwf, Ds, Xzg5^Es, Xzg5^Qov, Rd, Rd, Rd, Xzg5^Qov, Ds, Xzg5^Qov, Xzg5^Qov, Dd, Dd, Xu, Xu, Xu, Xu, Xu, Xu, Xu, Xu, Xu, Dd, Dd, Dd, Xu, Rd, Rd, Xu, Xu, Xu, Xu, Xu, Xu, Xu, Xu, Xu, Xu, Xu, Xu, Xu, Xu, Xu, Xu, Xu, Xu
Xu, Xu, Xu, Dd, Xu, Dd, Xzg5^Qov, Xzg5^Qov, Ds, Ds, Ss, Ds, Xzg5, Xzg5^Qov, Dd, Rd, Rd, Xu, Xu, Xu, Xu, Xu, Re, Xu, Re, Re, Rd, Rd, Xu, Xu, Xu, Xu, Xu, Xu, Dd, Xzg5^Qov, Xu, Xzg5^Qov, Xzg5^Qov, Ds, Ds, Ds, Rd, Ds, Ds, Ds, Ss, Ds^Es, Ds^Edb, Ds^Edb, Wwf, Rd, Wwf, Ds^Es, Ds^Es, Ds, Ds, Xzg5^Qov, Xzg5^Qov, Dd, Dd, Xu, Xu, Xu, Xu, Xu, Xu, Xu, Rd, Xu, Xu, Rd, Xu, Xu, Xu, Xu, Xu, Xu, Xu, Xu, Xu, Xu, Xu, Xu, Xu, Xu, Xu, Xu, Xu, Xu, Xu, Xu
Xu, Xu, Xu, Xu, Xu, Dd, Xzg5^Qov, Ds, Ds, Ss, Ss, Ds^Es, Ds^Es, Xzg5^Qov, Xzg5^Qov, Dd, Xu, Xu, Xu, Xu, Xu, Xu, Xu, Re, Xu, Xu, Xu, Xu, Xu, Xu, Xu, Xu, Xu, Xu, Dd, Xu, Xu, Xu, Xu, Xzg5^Qov, Dd, Rd, Dd, Xzg5, Ds, Ds, Ds, Ds^Edb, Ds^Edb, Ss, Ds, Wwf^Es, Ds^Es, Ds, Ds, Ds, Ss, Ds, Ds, Xzg5^Qov, Xzg5^Qov, Dd, Dd, Rd, Rd, Xu, Rd, Rd, Xu, Xu, Xu, Xu, Xu, Xu, Xu, Xu, Xu, Xu, Xu, Xu, Xu, Xu, Xu, Xu, Xu, Xu, Xu, Xu, Xu, Xu, Xu, Xu
Xu, Xu, Xu, Xu, Xuc, Dd, Dd, Xzg5^Qov, Ds, Ds, Ss, Ds^Edb, Ds^Edb, Xzg5, Xzg5^Qov, Dd, Dd, Xuc, Xuc, Xu, Xu, Rd, Rd, Rd, Xu, Xu, Xu, Xu, Xu, Xu, Xu, Xu, Xu, Xu, Rd, Rd, Rd, Rd, Rd, Dd, Rd, Rd, Dd, Xzg5^Qov, Xzg5^Qov, Xzg5^Qov, Xzg5^Qov, Ds, Ds, Ds, Xzg5, Ds^Es, Xzg5^Qov, Xzg5^Qov, Xzg5^Qov, Ds, Ds, Ss, Wwf, Ds, Ds, Xzg5^Qov, Xzg5^Qov, Xu, Rd, Rd, Xu, Xu, Xu, Xu, Xu, Xu, Xu, Xu, Xu, Xu, Xu, Xu, Xu, Xu, Xu, Xu, Xu, Xu, Xu, Xu, Xu, Xu, Xu, Xu, Xu, Xu
Xu, Xu, Xu, Xu, Xu, Xuc, Dd^Es, Xzg5^Qov, Xzg5^Qov, Ds, Ds, Ds^Edb, Ss, Ds, Ds, Xzg5^Qov, Dd, Xuc, Dd, Dd, Dd^Es, Dd, Rd, Xu, Xu, Xu, Xu, Xu, Xu, Xu, Xu, Xu, Xu, Re, Xu, Xu, Xu, Xu, Xu, Xu, Xu, Xu, Xu, Dd, Dd, Dd, Xu, Xzg5^Qov, Xzg5^Qov, Xzg5, Xzg5^Qov, Xzg5^Qov, Dd, Dd, Dd, Xzg5^Qov, Xzg5^Qov, Ds, Ds, Wwf, Ds, Ds, Xzg5^Qov, Dd, Dd^Es, Rd, Rd, Xu, Xu, Xu, Xu, Xu, Xu, Xu, Xu, Xu, Xu, Xu, Xu, Xu, Xu, Xu, Xu, Xu, Xu, Xu, Xu, Xu, Xu, Xu, Xu, Xu
Xu, Xu, Xu, Xu, Xu, Xuc, Xu, Dd^Es, Dd, Xzg5^Qov, Ds, Ds, Ss, Ss, Ds, Xzg5^Qov, Xzg5^Qov, Dd, Xzg5^Qov, Dd^Es, Xzg5^Qov, Dd, Dd, Xu, Rd, Xu, Rd, Xu, Xu, Xu, Xuc, Xu, Xuc, Rd, Xu, Xu, Re, Xu, Xu, Xu, Xu, Xu, Xu, Xu, Xu, Dd, Dd, Dd, Dd, Xu, Dd, Dd, Xu, Dd, Xu, Dd, Dd, Xzg5^Qov, Xzg5, Ds, Ds^Es, Xzg5, Xzg5^Qov, Xu, Xu, Rd^Es, Rd, Dd, Xu, Xu, Xu, Xu, Xu, Xu, Xu, Xu, Xu, Xu, Xu, Xu, Xu, Xu, Xu, Xu, Xu, Xu, Xu, Xu, Xu, Xu, Xu, Xu
Xu, Xu, Xu, Xu, Xu, Xu, Xu, Xu, Dd, Xzg5^Qov, Ds, Ss, Ss, Ss, Ss, Ds, Ds, Xzg5^Qov, Ds, Xzg5^Qov, Xzg5, Xzg5^Qov, Dd, Dd, Dd, Rd, Xuc, Rd, Rd, Xu, Dd, Xuc, Dd, Dd, Dd, Rd, Dd, Rd, Xu, Xuc, Xuc, Xu, Xu, Xu, Rd, Rd, Xu, Xu, Xu, Dd, Rd, Xu, Xu, Xu, Xu, Xu, Dd, Xu, Xzg5, Ds, Ds, Ds, Ds, Xzg5^Qov, Dd, Dd^Es, Rd, Xu, Xu, Xu, Xu, Xu, Xu, Xu, Xu, Xu, Xu, Xu, Xu, Xu, Xu, Xu, Xu, Xu, Xu, Xu, Xu, Xu, Xu, Xu, Xu, Xu
Xu, Xu, Xu, Xu, Xu, Xu, Xu, Xu, Dd, Xzg5^Qov, Xzg5^Qov, Ds, Wwf, Wwf, Ss, Ss, Ds, Ds, Ss, Ds, Ds, Xzg5^Qov, Xzg5^Qov, Dd, Rd, Dd, Dd, Dd, Dd, Dd, Dd, Dd, Xzg5^Qov, Dd, Xzg5^Qov, Xu, Xzg5^Qov, Dd, Dd, Dd, Dd, Xu, Xu, Rd, Rd, Xu, Xu, Xu, Xu, Xu, Xu, Rd, Rd, Xu, Xu, Xu, Dd, Xu, Xu, Xzg5, Ds^Es, Ss, Ds, Xzg5^Qov, Dd, Dd, Rd, Xu, Xu, Xu, Xu, Xu, Xu, Xu, Xu, Xu, Xu, Xu, Xu, Xu, Xu, Xu, Xu, Xu, Xu, Xu, Xu, Xu, Xu, Xu, Xu, Xu
Xu, Xu, Xu, Xu, Xu, Xu, Xu, Xu, Dd^Vdt, Dd, Xzg5^Qov, Ds, Ds^Edb, Ds^Es, Ds^Edb, Wwf, Wwf, 6 Ss, Wwf, Ss, Rd, Rd, Re, Re, Dd, Rd, Dd^Es, Dd^Es, Xzg5^Qov, Xzg5^Qov, Xzg5^Qov, Xzg5^Qov, Xzg5^Es, Xzg5^Qov, Ds, Xzg5^Qov, Xzg5, Xzg5^Qov, Xzg5^Qov, Dd, Dd, Dd, Dd, Dd, Dd, Xu, Xu, Xu, Xuc, Xu, Rd, Dd, Xu, Rd, Rd, Rd, Xu, Xu, Xu, Xzg5, Ds^Es, Ds, Xzg5, Xzg5^Qov, Dd, Xu, Xu, Xu, Xu, Xu, Xu, Xu, Xu, Xu, Xu, Xu, Xu, Xu, Xu, Xu, Xu, Xu, Xu, Xu, Xu, Xu, Xu, Xu, Xu, Xu, Xu, Xu
Xu, Xu, Xu, Xu, Xu, Xu, Xu, Xuc, Xuc, Dd, Xzg5^Qov, Xzg5^Vdt, Xzg5, Xzg5^Edb, Ds^Edb, Ss, Ss, Wwf, Ss, Ss, Wwf, Ds, Ds, Dd, Dd, Dd, Xzg5^Qov, Dd, Xzg5^Qov, Xzg5, Ds^Es, Ds, Ds, Ds, Xzg5^Qov, Xzg5, Rd, Xzg5, Xzg5, Xzg5^Qov, Xzg5^Qov, Dd, Xzg5^Qov, Xzg5^Qov, Xzg5^Qov, Dd, Dd, Xuc, Xuc, Rd, Dd, Xu, Xu, Xu, Xu, Rd, Xuc, Xu, Xu, Xu, Ds, Ds^Es, Ds, Xzg5^Qov, Xzg5^Qov, Dd, Xu, Xu, Xu, Xu, Xu, Xu, Xu, Xu, Xu, Xu, Xu, Xu, Xu, Xu, Xu, Xu, Xu, Xu, Xu, Xu, Xu, Xu, Xu, Xu, Xu, Xu
Xu, Xu, Xu, Xu, Xu, Xu, Xu, Xu, Xuc, Dd, Dd^Es, Xzg5^Qov, Xzg5^Qov, Xzg5, Re^Edb, Rd^Edb, Rd, Wwf, Ss, Ss, Ds, Ss, Ds, Xzg5^Qov, Xzg5^Qov, Xzg5^Qov, Ds, Xzg5^Qov, Xzg5, Ds, Ds, Ss, Ds, Xzg5^Qov, Dd, Xzg5^Qov, Xzg5^Qov, Rd, Rd, Xzg5, Xzg5, Xzg5^Qov, Rd^Edb, Xzg5, Xzg5^Qov, Dd, Dd, Dd, Dd, Dd^Es, Dd^Es, Dd^Es, Dd, Dd, Dd, Rd, Rd, Xuc, Xzg5^Qov, Xu, Ds, Ss, Wwf, Ds^Es, Xzg5^Qov, Dd, Xu, Xu, Xu, Xu, Xu, Xu, Xu, Xu, Xu, Xu, Xu, Xu, Xu, Xu, Xu, Xu, Xu, Xu, Xu, Xu, Xu, Xu, Xu, Xu, Xu, Xu
Xu, Xu, Xu, Xu, Xu, Xu, Xu, Xu, Re, Rd, Dd^Es, Dd, Dd, Dd, Re, Re, Xzg5, Ds, Ds, Ds, Xzg5^Qov, Ds, Ds, Xzg5, Xzg5, Ds, Ds, Xzg5, Xzg5^Qov, Xzg5^Qov, Xzg5^Qov, Ds, Xzg5^Qov, Xzg5^Qov, Dd, Dd, Dd, Xzg5^Qov, Xzg5^Qov, Xzg5, Xzg5^Edb, Rd, Rd^Edb, Xzg5, Rd, Re, Xzg5^Qov, Xzg5^Qov, Xzg5^Qov, Dd, Xzg5^Qov, Xzg5^Qov, Xzg5^Qov, Xzg5^Qov, Xzg5^Qov, Dd^Es, Dd^Es, Dd^Vdt, Xzg5^Qov, Ds, Ss, Ss, Wwf, Ds, Xzg5^Qov, Dd, Xu, Xu, Xu, Xu, Xu, Xu, Xu, Xu, Xu, Xu, Xu, Xu, Xu, Xu, Xu, Xu, Xu, Xu, Xu, Xu, Xu, Xu, Xu, Xu, Xu, Xu
Xu, Xu, Xu, Xu, Xu, Xu, Xu, Re, Ce, Ce, Ce, Rd, Rd, Rd, Dd^Es, Dd, Xzg5^Qov, Ds, Xzg5^Qov, Xzg5^Qov, Dd^Vdt, Xzg5^Qov, Xzg5^Qov, Xzg5^Es, Xzg5^Qov, Xzg5, Xzg5^Qov, Xzg5^Qov, Dd, Dd, Dd, Xzg5^Qov, Dd, Dd, Xuc, Dd, Xuc, Dd, Xzg5^Qov, Xzg5^Es, Xzg5^Edb, Xzg5^Edb, Rd^Edb, Rd^Edb, Xzg5^Edb, Xzg5, Ds^Es, Ds, Ds, Xzg5^Qov, Ds, Ds, Ds, Ds, Ds^Es, Xzg5^Qov, Xzg5^Qov, Xzg5^Qov, Ds, Ds, Ss, Wwf, Ss, Ds, Xzg5^Qov, Dd, Dd, Xu, Xu, Xu, Xu, Xu, Xu, Xu, Xu, Xu, Xu, Xu, Xu, Xu, Xu, Xu, Xu, Xu, Xu, Xu, Xu, Xu, Xu, Xu, Xu, Xu
Xu, Xu, Xu, Xu, Xu, Xu, Xu, Re, Ce, 1 Ket, Ce, Rd, Dd, Dd, Dd, Dd, Dd, Xzg5^Qov, Dd, Dd, Rd, Dd, Dd, Xzg5^Qov, Dd, Xzg5^Qov, Dd, Dd^Es, Dd^Es, Dd, Xu, Dd, Xu, Xu, Xu, Xuc, Xuc, Dd, Dd, Xzg5^Qov, Re, Xzg5, Re, Xzg5^Edb, Xzg5^Es, Ds, Ss, Ss, Wwf, Ds, Ss, Ss, Ss, Ss, Ds^Es, Ds, Xzg5, Ds, Ds, Ss, Ss, Ss, Ss, Ds, Ds, Xzg5^Qov, Dd, Xu, Rd, Xu, Xu, Xu, Xu, Xu, Xu, Xu, Xu, Xu, Xu, Xu, Xu, Xu, Xu, Xu, Xu, Xu, Xu, Xu, Xu, Xu, Xu, Xu
Xu, Xu, Xu, Xu, Xu, Xu, Xu, Re, Re, Ce, Rd, Rd, Xu, Xu, Xu, Dd, Xu, Dd, Rd, Xuc, Rd, Rd, Xuc, Dd, Dd, Dd, Xu, Dd, Xu, Xu, Xu, Xu, Xu, Xu, Rd, Xu, Dd, Xu, Xu, Dd, Rd, Re, Dd, Xzg5^Qov, Xzg5^Qov, Ds, Ds, Ss, Ds, Wwf, Ss, Wwf, Ds, Ds, Xzg5^Qov, Ds^Es, Xzg5^Qov, Xzg5^Qov, Xzg5^Qov, Ds, Ds, Wwf, Wwf, Ss, Ds, Xzg5^Qov, Dd, Rd, Xuc, Xuc, Xu, Xu, Xu, Xu, Xu, Xu, Xu, Xu, Xu, Xu, Xu, Xu, Xu, Xu, Xu, Xu, Xu, Xu, Xu, Xu, Xu, Xu
Xu, Xu, Xu, Xu, Xu, Xu, Xu, Xu, Xu, Rd, Rd, Dd, Xu, Xu, Xu, Xu, Xu, Xu, Rd, Rd, Xu, Xu, Xu, Xu, Xu, Xu, Xu, Xu, Xu, Xu, Xu, Dd^Vdt, Dd, Rd, Ce, Rd, Rd, Dd, Xu, Xuc, Rd, Xuc, Xuc, Dd, Dd, Xzg5^Qov, Xzg5^Qov, Ds, Xzg5^Qov, Ds, Ds, Ds, Ds, Xzg5^Qov, Dd, Xzg5^Qov, Dd, Dd, Dd^Es, Xzg5^Qov, Xzg5^Qov, Ds, Wwf, Ss, Ds, Xzg5^Qov, Re, Rd, Dd, Xuc, Xuc, Xu, Xu, Xu, Xu, Xu, Xu, Xu, Xu, Xu, Xu, Xu, Xu, Xu, Xu, Xu, Xu, Xu, Xu, Xu, Xu, Xu
Xu, Xu, Xu, Xu, Xu, Xu, Xu, Xu, Xu, Xu, Xu, Rd, Rd, Dd, Xu, Xu, Dd, Dd^Es, Rd, Dd, Xu, Xu, Xu, Xu, Xu, Xu, Xu, Xu, Xu, Xu, Xu, Dd, Dd, Ce, 3 Ket, Ce, Rd, Rd, Rd, Rd, Xu, Xu, Xu, Xu, Xu, Dd, Xzg5^Qov, Xzg5^Qov, Dd, Xzg5^Qov, Xzg5^Qov, Xzg5^Qov, Xzg5^Qov, Xzg5^Qov, Dd, Dd, Rd, Rd^Es, Rd, Dd, Xzg5^Qov, Ds, Ds, Ss, Ds, Re, Xzg5, Dd, Dd, Xuc, Xuc, Xu, Xu, Xu, Xu, Xu, Xu, Xu, Xu, Xu, Xu, Xu, Xu, Xu, Xu, Xu, Xu, Xu, Xu, Xu, Xu, Xu
Xu, Xu, Xu, Xu, Xu, Xu, Xu, Xu, Xu, Xu, Xu, Dd^Es, Rd, Dd, Dd^Es, Dd^Es, Rd, Rd, Dd^Es, Dd, Xu, Xu, Xu, Xu, Xu, Xu, Xu, Xu, Xu, Xu, Xu, Xu, Dd, Ce, Ce, Ce, Dd, Xu, Xu, Xu, Xu, Xu, Xu, Xu, Xu, Dd, Rd, Dd, Xuc, Dd, Dd, Dd, Dd, Dd, Xu, Xuc, Xuc, Xuc, Xu, Dd, Dd, Xzg5^Qov, Ds, Wwf, Ss, Ds, Xzg5, Xzg5^Qov, Dd^Es, Dd, Xuc, Xu, Xu, Xu, Xu, Xu, Xu, Xu, Xu, Xu, Xu, Xu, Xu, Xu, Xu, Xu, Xu, Xu, Xu, Xu, Xu, Xu
Xu, Xu, Xu, Xu, Xu, Xu, Xu, Xu, Dd^Es, Xu, Rd, Rd, Rd, Rd, Dd, Dd, Rd, Dd^Es, Dd^Es, Xu, Xu, Xu, Xu, Xu, Xu, Xu, Xu, Xu, Xu, Xu, Xu, Xu, Xu, Dd, Dd^Vdt, Dd, Xu, Xu, Xu, Xu, Xu, Xu, Xu, Xu, Xu, Xu, Xu, Rd, Rd, Rd, Rd, Rd, Dd^Vdt, Dd, Xu, Xu, Xu, Xu, Xu, Xu, Dd, Xzg5^Qov, Xzg5^Qov, Ds, Ds, Ds, Xzg5, Xzg5^Qov, Dd^Es, Dd^Es, Dd, Xu, Xu, Xu, Xu, Xu, Xu, Xu, Xu, Xu, Xu, Xu, Xu, Xu, Xu, Xu, Xu, Xu, Xu, Xu, Xu, Xu
Xu, Xu, Xu, Xu, Xu, Xu, Xu, Dd, Rd, Rd, Dd, Xu, Xu, 7 Rd, Xu, Xu, Dd, Rd, Dd^Es, Dd^Es, Xu, Xu, Xu, Xu, Xu, Xu, Xu, Xu, Xu, Xu, Xu, Xu, Xu, Xu, Xu, Xu, Xu, Xu, Xu, Xu, Xu, Xu, Xu, Xu, Xu, Xu, Xu, Xu, Xuc, Xuc, Xuc, Xuc, Xu, Xu, Xu, Xu, Re, Rd, Dd, Xu, Xuc, Dd, Dd, Xzg5^Qov, Xzg5^Qov, Ds^Es, Xzg5, Xzg5^Qov, Dd^Es, Dd^Es, Dd, Xu, Xu, Xu, Xu, Xu, Xu, Xu, Xu, Xu, Xu, Xu, Xu, Xu, Xu, Xu, Xu, Xu, Xu, Xu, Xu, Xu
Xu, Xu, Xu, Xu, Xu, Xu, Xu, Rd, Dd^Es, Dd^Es, Dd, Xu, Rd, Rd, Xu, Xu, Dd, Rd, Rd, Dd, Xu, Xu, Xu, Xu, Xu, Xu, Xu, Xu, Xu, Xu, Xu, Xu, Xu, Xu, Xu, Xu, Xu, Xu, Xu, Xu, Xu, Xu, Xu, Xu, Xu, Xu, Xu, Xu, Xu, Xu, Xu, Xu, Xu, Xu, Xu, Xu, Xu, Xu, Dd, Xu, Xuc, Xuc, Dd, Dd, Xzg5^Qov, Xzg5^Es, Rd, Xzg5^Qov, Xzg5^Qov, Dd^Es, Dd, Dd, Xu, Xu, Xu, Xu, Xu, Xu, Xu, Xu, Xu, Xu, Xu, Xu, Xu, Xu, Xu, Xu, Xu, Xu, Xu, Xu
Xu, Xu, Xu, Xu, Xu, Xu, Dd^Ii, Rd, Rd^Ii, Dd, Xu, Rd, Xu, Rd, Rd^Ii, Rd, Rd^Ii, Rd, Dd^Ii, Xu, Xu, Xu, Xu, Xu, Xu, Xu, Xu, Xu, Xu, Xu, Xu, Xu, Xu, Xu, Xu, Xu, Xu, Xu, Xu, Xu, Xu, Xu, Xu, Xu, Xu, Xu, Xu, Xu, Xu, Xu, Xu, Xu, Xu, Xu, Xu, Xu, Xu, Xu, Xu, Dd, Dd, Dd, Xzg5^Qov, Xzg5^Qov, Xzg5, Xzg5, Rd, Xzg5^Es, Xzg5^Es, Xzg5^Qov, Dd, Dd, Xu, Xu, Xu, Xu, Xu, Xu, Xu, Xu, Xu, Xu, Xu, Xu, Xu, Xu, Xu, Xu, Xu, Xu, Xu, Xu
Xu, Xu, Xu, Xu, Xu, Dd^Ii, Dd^Ii, Rd^Ii, Rd^Ii, Dd^Ii, Xu, Rd^Ii, Xu, Xu, Xu, Dd^Ii, Dd, Rd^Ii, Dd, Dd^Ii, Xu, Xu, Xu, Xu, Xu, Xu, Xu, Xu, Xu, Xu, Xu, Xu, Xu, Xu, Xu, Xu, Xu, Xu, Xu, Xu, Xu, Xu, Xu, Xu, Xu, Xu, Xu, Xu, Xu, Xu, Xu, Xu, Xu, Xu, Xu, Xu, Xu, Xu, Xu, Xu, Dd, Dd, Xzg5^Qov, Xzg5, Rd, Rd, Rd, Rd, Xzg5, Xzg5^Qov, Dd, Dd, Xu, Xu, Xu, Xu, Xu, Xu, Xu, Xu, Xu, Xu, Xu, Xu, Xu, Xu, Xu, Xu, Xu, Xu, Xu, Xu
