Dd, Dd, Dd^Es, Dd^Es, Dd, Dd^Es, Dd, Dd, Dd, Dd, Dd, Dd, Dd, Dd, Dd, Dd, Dd, Dd, Dd, Dd, Dd, Dd^Es, Dd^Es, Dd, Dd, Dd, Dd, Dd, Dd, Dd^Es, Dd, Dd, Dd, Dd, Dd, Dd, Dd, Dd, Dd, XUrb, Dd^Qov, XUrb, Dd^Qov, XUrb, XUrb, Dd^Es, Dd^Es, Dd, Dd, Dd, Dd, Dd, Dd, Dd, Dd^Es, Dd
Dd, Dd, Dd^Es, Dd^Es, Dd, Dd^Es, Dd, Dd, Dd, Dd, Dd, Dd, Dd, Dd, Dd, Dd, Dd, Dd, Dd, Dd, Dd, Dd^Es, Dd^Es, Dd, Dd, Dd, Dd, Dd, Dd, Dd^Es, Dd, Dd, Dd, Dd, Dd, Dd, XUrb, Dd, Dd^Qov, Dd^Qov, Tptz, Dd^Qov, Tptz, Dd^Qov, Dd^Qov, Dd^Es, Dd^Es, Dd, Dd, Dd, Dd, Dd, Dd, Dd, Dd^Es, Dd
Dd, Dd, Dd^Es, Dd^Es, Dd^Es, Dd, Dd, Dd^Es, Dd, Dd, Dd, Dd, Dd, Dd^Es, Dd^Es, Dd, Dd^Es, Dd, Dd, Dd, Dd, Dd^Es, Dd, Dd^Es, Dd, Dd, Dd, Dd, Dd^Es, Dd, Dd^Es, Dd, Dd, Dd, Dd, XUrb, XUrb, Dd^Qov, Tptz, Tptz, Tptz^Rusy, Tptz, Tptz^Rusy, Tptz, Tptz, Dd^Qov, XUrb, Dd^Es, Dd, Dd, Dd, Dd, Dd, Dd^Es, Dd, Dd
Dd, Dd, Dd, Dd^Es, Dd^Es, Dd^Es, Dd^Vdr, Dd^Edp, Dd^Fts, Dd^Fts, Dd, Dd, Dd, Dd^Es, Dd, Dd^Es, Dd, Dd, Dd, Dd, Dd^Es, Dd, Dd, Dd, Dd, Dd, Dd, Dd, Dd, Dd^Es, Dd^Fts, Dd, Dd^Fts, Dd, Dd, Dd^Es, XUrb, Dd^Qov, Tptz, Tptz, Tptz, Tptz, Tptz, Tptz, Tptz, Dd^Qov, XUrb, Dd, Dd, Dd, Dd^Es, Dd^Es, Dd, Dd, Dd, Dd
Dd, Dd, Dd, Dd^Edp, Dd^Edp, Dd, Dd^Edp, Dd^Es, Dd, Dd^Fts, Dd^Fts, Dd^Fts, Dd^Es, Dd, Dd^Es, Dd, Dd^Edp, Dd^Edp, Dd^Edp, Dd^Es, Dd^Es, Dd^Es, Dd, Dd, Dd^Es, Dd^Es, Dd^Es, Dd^Vdr, Dd^Es, Dd^Edp, Dd^Edp, Dd^Fts, Dd, Dd, Dd, XUrb, Dd^Qov, Dd^Qov, Tphz, Tphz, Tphz, Tphz, Tphz, Tphz, Tphz, Dd^Qov, Dd^Qov, Dd, Dd, Dd, Dd, Dd^Es, Dd^Es, Dd, Dd, Dd
Dd, Dd, Dd, Dd^Edp, Dd, Dd, Dd, Dd, Dd, Dd, Dd, Dd, Dd^Es, Dd^Es, Dd^Es, Dd^Edp, Dd^Es, Dd, Dd, Dd, Dd^Edp, Dd, Dd, Dd, Dd, Dd^Edp, Dd^Edp, Dd^Edp, Dd, Dd^Es, Dd, Dd, Dd, Dd, Dd, XUrb, Dd^Qov, Tptz, Tphz^Tyod, Tphz, Tphz, Tphz, Tphz, Tphz, Tphz^Tyod, Tptz, Dd^Qov, XUrb, Dd, Dd, Dd, Dd, Dd, Dd, Dd^Es, Dd
Dd, Dd, Dd, Dd, Dd, Dd, Dd, Dd, Dd^Qov, Dd^Qov, Dd^Qov, Dd, Dd, Dd, Dd, Dd, Dd, Dd, Dd, Dd, Dd, Dd, Dd, Dd, Dd, Dd, Dd, Dd, Dd, Dd, Dd, Dd, Dd, Dd, Dd^Qov, Dd^Qov, Tptz, Tptz, Tptz, Tptz, Tptz, Tptz, Tptz, Tptz, Tptz, Tptz, Tptz, Dd^Qov, Dd^Qov, Dd, Dd, Dd, Dd, Dd, Dd, Dd
Dd^Qov, Dd^Qov, Dd^Qov, Dd^Qov, Dd^Qov, Dd^Qov, Dd^Qov, Dd^Qov, Tptz^Qov, Tptz^Qov, Tptz^Qov, Dd^Qov, Dd^Qov, Dd^Qov, Dd^Qov, Dd^Qov, Dd^Qov, Dd^Qov, Dd^Qov, Dd^Qov, Dd^Qov, Dd^Qov, Dd^Qov, Dd^Qov, Dd^Qov, Dd^Qov, Dd^Qov, Dd^Qov, Dd^Qov, Dd^Qov, Dd^Qov, Dd^Qov, Dd^Qov, Dd^Qov, Tptz^Qov, Tptz, Tptz, Tptz, Tptz, Tptz, Tptz^Rusy, Tptz^Rusy, Tptz^Rusy, Tptz, Tptz, Tptz, Tptz, Tptz, Tptz^Qov, Dd^Qov, Dd^Qov, Dd^Qov, Dd^Qov, Dd^Qov, Dd^Qov, Dd^Qov
Dd, Tptz, Tptz, Tptz, Tptz, Tptz, Tptz, Tptz, Tptz, Tphz^Tyod, Tptz, Tptz, Tptz, Tptz, Tptz, Tptz, Tptz, Tptz, Tptz, Tptz, Tptz, Tptz, Tptz, Tptz, Tptz, Tptz, Tptz, Tptz, Tptz, Tptz, Tptz, Tptz, Tptz, Tptz, Tptz, Tphz, Tphz, Tptz, Tphz, Tptz, Tptz, Tptz, Tptz, Tptz, Tphz, Tptz, Tphz, Tphz, Tptz, Tptz, Tptz, Tptz, Tptz, Tptz, Tptz, Tptz
Dd, Tptz, Tptz^Rusy, Tptz, Tptz, Tptz, Tptz, Tptz, Tptz, Tptz, Tptz, Tptz, Tptz, Tptz^Dr, Tptz^Rusy, Tptz^Rusy, Tptz^Rusy, Tptz^Rusy, Tptz^Rusy, Tptz, Tptz, Tptz, Tptz^Rusy, Tptz, Tptz^Rusy, Tptz, Tptz, Tptz^Rusy, Tptz^Rusy, Tptz^Rusy, Tptz^Rusy, Tptz^Rusy, Tptz^Rusy, Tptz, Tptz, Tptz, Tptz, Tphz^Tyod, Tptz^Qov, Tphz, Tphz, Tphz, Tphz, Tphz, Tptz^Qov, Tphz^Tyod, Tptz, Tptz, Tptz^Rusy, Tptz^Rusy, Tptz^Rusy, Tptz^Rusy, Tptz^Rusy, Tptz^Rusy, Tptz^Rusy, Tptz
Dd, Tptz, Tptz, Tptz, Tptz, Tptz^Dr, Tptz, Tptz, Tptz^Dr, Tptz, Tptz, Tptz, Tptz, Tptz^Rusy, Tptz^Rusy, Tptz^Rusy, Tptz^Rusy, Tptz^Rusy, Tptz, Tptz, Tptz, Tptz^Dr, Tptz, Tptz^Rusy, Tptz, Tptz, Tptz^Rusy, Tptz, Tptz^Rusy, Tptz^Rusy, Tptz^Rusy, Tptz^Rusy, Tptz, Tptz^Rusy, Tptz^Dr, Tptz^Rusy, Tptz, Tptz, Tphz, Tphz, Tphz, Tphz, Tphz, Tphz, Tphz, Tptz, Tptz, Tptz, Tptz, Tptz^Rusy, Tptz^Rusy, Tptz^Rusy, Tptz^Rusy, Tptz^Rusy, Tptz, Tptz
Dd, Tptz, Tptz, Tptz, Tptz, Tptz, Tptz, Tptz, Tphz, Tptz^Dr, Tphz, Tptz, Tptz, Tptz, Tptz, Tptz, Tptz, Tptz, Tptz, Tptz, Tptz, Tptz, Tptz, Tptz, Tptz, Tptz, Tptz, Tptz, Tptz, Tptz, Tptz, Tptz, Tptz, Tptz, Tptz, Tptz, Tphz, Tphz, Tptz, Tphz, Tphz, Tphz, Tphz, Tphz, Tptz, Tphz, Tphz, Tptz, Tptz, Tptz, Tptz, Tptz, Tptz, Tptz, Tptz, Tptz
Dd, Tphz, Tphz, Tphz, Tphz, Tphz, Tphz, Tphz, Tptz, Tphz^Tyod, Tptz, Tphz, Tphz, Tphz, Tphz, Tphz, Tphz, Tphz, Tphz, Tphz, Tphz, Tphz, Tphz, Tphz, Tphz, Tphz, Tphz, Tphz, Tphz, Tphz, Tphz, Tphz, Tphz, Tphz, Tphz, Tphz, Tptz, Tptz, Tptz, Tptz, Tptz^Cov, Tptz^Kov, Tptz^Cov, Tptz, Tptz, Tptz, Tptz, Tphz, Tphz, Tphz, Tphz, Tphz, Tphz, Tphz, Tphz, Tphz
Dd, Tptz, Tptz, Tptz^Ebn, Tptz, Tptz^Ebn, Tptz, Tptz, Tptz^Dr, Tptz, Tptz, Tptz, Tptz, Tptz^Ebn, Tptz, Tptz^Ebn, Tptz, Tptz^Ebn, Tptz, Tptz^Ebn, Tptz, Tptz^Ebn, Tptz, Tptz^Ebn, Tptz, Tptz^Ebn, Tptz, Tptz^Eb, Tptz, Tptz^Ebn, Tptz, Tptz^Ebn, Tptz, Tptz^Ebn, Tptz, Tptz, Tptz, Tptz, Tptz, Tptz^Rusy, Tptz^Rusy, Tptz^Cov, Tptz^Rusy, Tptz, Tptz, Tptz, Tptz, Tptz, Tptz, Tptz^Ebn, Tptz, Tptz^Ebn, Tptz, Tptz^Ebn, Tptz, Tptz
Dd, Tptz, Tptz^Dr, Tptz, Tptz, Tptz, Tptz, Tptz, Tptz^Rusy, Tptz^Rusy, Tptz^Rusy, Tptz, Tptz^Rusy, Tptz, Tptz^Rusy, Tptz^Rusy, Tptz^Rusy, Tptz^Rusy, Tptz, Tptz, Tptz^Dr, Tptz, Tptz^Rusy, Tptz^Rusy, Tptz^Rusy, Tptz, Tptz, Tptz, Tptz^Rusy, Tptz, Tptz, Tptz, Tptz, Tptz, Tptz, Tptz, Tptz^Rusy, Tptz, Tptz, Tptz, Tptz, Tptz, Tptz, Tptz, Tptz, Tptz^Rusy, Tptz^Rusy, Tptz, Tptz, Tptz, Tptz^Rusy, Tptz, Tptz, Tptz, Tptz, Tptz
Dd, Tptz, Tptz, Tptz, Tptz, Tptz, Tptz, Tptz, Tptz, Tptz, Tptz, Tptz^Rusy, Tptz, Tptz^Rusy, Tptz^Rusy, Tptz^Rusy, Tptz^Rusy, Tptz^Rusy, Tptz, Tptz, Tptz^Rusy, Tptz, Tptz, Tptz, Tptz, Tptz, Tptz^Dr, Tptz, Tptz, Tptz, Tptz, Tptz, Tptz^Rusy, Tptz^Rusy, Tptz, Tptz, Tptz, Tptz, Tphz, Tphz, Tphz, Tphz, Tphz, Tphz, Tphz, Tptz, Tptz, Tptz^Rusy, Tptz, Tptz, Tptz, Tptz, Tptz, Tptz, Tptz, Tptz
Dd, Tptz, Tphz, Tptz, Tphz, Tptz, Tphz, Tptz, Tptz, Tptz^Dr, Tphz, Tptz, Tphz, Tptz^Rusy, Tptz^Rusy, Tptz^Rusy, Tptz, Tptz, Tphz, Tptz, Tphz, Tptz, Tphz, Tptz, Tptz, Tptz, Tphz, Tptz, Tphz, Tptz, Tphz, Tptz, Tptz, Tptz, Tphz, Tptz, Tphz, Tphz, Tphz, Tphz, Tphz, Tphz, Tphz, Tphz, Tphz, Tphz, Tphz, Tptz, Tphz, Tptz, Tptz, Tptz, Tphz, Tptz, Tphz, Tptz
Dd, Tphz, Tphz, Tphz, Tphz, Tphz, Tphz, Tphz, Tphz, Tphz, Tphz, Tphz, Tphz, Tphz^Rusy, Tptz^Rusy, Tptz^Rusy, Tphz^Rusy, Tphz, Tphz, Tphz, Tphz, Tphz, Tphz, Tphz, Tphz, Tphz, Tphz, Tphz, Tphz, Tphz, Tphz, Tphz, Tphz, Tphz, Tphz, Tphz, Tphz^Tpwz, Tphz, Tphz, Tphz, Tphz, Tphz, Tphz, Tphz, Tphz, Tphz, Tphz^Tpwz, Tphz, Tphz, Tphz, Tphz, Tphz, Tphz, Tphz, Tphz, Tphz
Dd, Tphz, Tphz, Tphz, Tphz, Tphz, Tphz, Tphz, Tphz, Tphz, Tphz, Tphz, Tphz, Tphz^Rusy, Tptz^Rusy, Tptz^Rusy, Tphz^Rusy, Tphz, Tphz, Tphz, Tphz, Tphz, Tphz, Tphz, Tphz, Tphz, Tphz, Tphz, Tphz, Tphz, Tphz, Tphz, Tphz, Tphz, Tphz, Tphz, Tphz, Tphz, Tphz, Tphz, Tphz^Tycd, Tfhz, Tphz^Tycd, Tphz, Tphz, Tphz, Tphz, Tphz, Tphz, Tphz, Tphz, Tphz, Tphz, Tphz, Tphz, Tphz
Dd, Tphz, Tphz, Tphz, Tphz, Tphz, Tphz, Tphz, Tphz, Tphz, Tphz, Tphz, Tphz, Tphz^Rusy, Tptz^Rusy, Tptz^Rusy, Tphz^Rusy, Tphz, Tphz, Tphz, Tphz, Tphz, Tphz, Tphz, Tphz, Tphz, Tphz, Tphz, Tphz, Tphz, Tphz, Tphz, Tphz, Tphz, Tphz, Tphz, Tphz, Tphz, Dd, Dd, Re, Rd, Rd, Dd, Dd, Tphz, Tphz, Tphz, Tphz, Tphz, Tphz, Tphz, Tphz, Tphz, Tphz, Tphz
Dd, Tphz, Dd, Tphz, Dd, Tphz, Dd, Tphz, Tphz, Tphz, Dd, Tphz^Rusy, Dd, Tphz^Rusy, Tptz^Rusy, Tptz^Rusy, Tphz^Rusy, Tphz, Dd, Tphz, Dd, Tphz, Dd, Tphz, Tphz, Tphz, Dd, Tphz, Dd, Tphz, Dd, Tphz, Tphz, Tphz, Dd, Tphz^Tycd, Dd, Dd, Dd, Re^Rusy, Re, 2 Re, Rd, Rd, Dd, Dd, Dd, Tphz^Tycd, Dd, Tphz, Tphz, Tphz, Dd, Tphz, Dd, Tphz
Dd, Dd, Dd^Dc, Dd, Dd^Edp, Dd^Dc, Dd, Dd, Dd, Dd^Rusy, Dd^Rusy, Dd, Dd^Rusy, Dd^Rusy, Dd^Rusy, Tptz^Rusy, Dd^Rusy, Dd, Dd^Rusy, Dd, Dd^Rusy, Dd, Dd^Rusy, Dd, Dd, Dd, Dd^Rusy, Dd^Rusy, Dd^Rusy, Dd, Dd^Dc, Dd, Dd, Dd, Dd, Dd, Dd, Dd^Rusy, Dd^Rusy, Re^Rusy, Rd^Rusy, Rd, Rd, Rd, Dd^Dc, Dd, Dd^Edp, Dd, Dd^Rusy, Dd, Dd, Dd, Dd^Rusy, Dd^Rusy, Dd, Dd
Dd, Dd^Edp, Dd^Edp, Dd^Edp, Dd, Dd, Xzg5^Qov, Dd, Xzg5^Qov, Dd, Dd, Dd^Rusy, Dd^Es, Dd^Rusy, Dd^Rusy, Dd^Rusy, Dd^Rusy, Dd^Rusy, Dd^Rusy, Dd^Rusy, Dd^Dc, Dd, Dd^Edp, Dd, Dd^Es, Dd^Rusy, Dd^Edp, Dd^Rusy, Dd^Rusy, Dd^Rusy, Dd^Es, Dd^Vdr, Dd^Rusy, Dd^Rusy, Dd^Rusy, Dd^Vdr, Dd^Dc, Rd^Rusy, Re^Rusy, Re^Rusy, Dd, Rd, Rd, Dd, Dd^Rusy, Dd^Vdr, Dd^Edp, Dd^Edp, Dd^Rusy, Dd^Rusy, Dd^Rusy, Dd^Rusy, Dd^Es, Dd^Edp, Dd^Edp, Dd
Xzg2^Qov, Dd, Dd, Dd, Xzg5^Qov, Dd, Xzg5^Qov, Xzg5^Qov, Xzg5^Qov, Xzg5^Qov, Xzg5^Qov, Dd, Dd, Dd, Dd, Dd^Es, Dd, Dd, Dd, Dd^Rusy, Dd, Dd^Es, Dd^Edp, Xzg2^Qov, Xzg2^Qov, Dd^Es, Dd^Es, Dd, Xzg2^Qov, Dd^Esd, Dd^Es, Dd, Dd^Rusy, Dd^Edp, Re, Dd, Rd, Rd, Rd, Re^Rusy, Re, Dd^Es, Rd, Rd, Re, Rd^Rusy, Re, Dd^Edp, Rd^Rusy, Dd^Es, Dd, Dd^Es, Xzg2^Qov, Dd, Dd^Edp, Dd
Xzg2^Qov, Xzg2^Qov, Dd, Xzg5^Qov, Xzg4, Xzg5^Qov, Xzg4, Xzg4, Xzg4^Qov, Xzg5^Qov, Xzg4^Qov, Xzg5^Qov, Xzg5^Qov, Xzg5^Qov, Xzg5^Qov, Dd, Xzg5^Qov, Xzg5^Qov, Xzg5^Qov, Dd, Dd^Edp, Dd^Edp, Dd^Edp, Xzg2^Qov, Dd, Dd^Es, Dd^Es, Xzg2^Qov, Xzg2^Qov, Xzg2^Qov, Dd, Dd^Dc, Dd, Dd^Vdr, Dd, Re, Dd, Rd, Dd, Re, Re, Dd, Dd, Rd, Re, Re, Dd, Rd, Dd^Vdr, Rd, Rd, Dd, Dd, Xzg2^Qov, Dd, Dd
Dd, Dd, Xzg5^Qov, Xzg5^Qov, Xzg4, Xzg4, Xzg4^Qov, Xzg4^Qov, Xzg5^Vdt, Xzg4^Qov, Xzg4^Qov, Xzg4^Qov, Xzg4^Qov, Xzg4^Qov, Xzg4^Qov, Xzg5^Qov, Xzg4^Qov, Xzg4^Qov, Xzg5^Qov, Dd, Dd, Dd, Dd, Dd^Edp, Dd^Edp, Dd^Edp, Dd^Es, Dd, Dd^Esd, Dd^Edp, Dd^Edp, Dd, Dd^Edp, Dd^Rusy, Dd^Vdr, Dd, Dd^Es, Dd^Dc, Dd^Es, Dd, Rd, Rd, Rd, Rd, Rd, Dd^Vdr, Rd^Rusy, Rd, Rd, Dd^Rusy, Dd^Rusy, Dd^Rusy, Dd, Dd, Xzg5^Qov, Dd
Xzg5^Qov, Dd, Xzg5^Qov, Xzg4, Xzg4^Qov, Xzg4^Qov, Xzg4^Qov, Xzg5, Xzg5^Edp, Xzg5, Xzg5, Xzg4, Xzg4^Es, Xzg4, Rd, Xzg4^Qov, Rd, Xzg4^Qov, Xzg4^Qov, Xzg5^Qov, Xzg5^Qov, Xzg5^Qov, Dd, Dd^Edp, Dd, Dd, Dd, Dd^Dc, Dd, Dd^Edp, Dd, Dd^Edp, Dd, Dd^Rusy, Dd^Rusy, Dd, Dd^Edp, Dd^Es, Dd^Edp, Dd^Es, Dd, Rd, Re, Dd, Dd, Dd^Rusy, Dd^Rusy, Dd^Dc, Dd^Es, Dd^Rusy, Dd^Es, Dd^Vdr, Dd, Xzg5^Qov, Xzg5^Qov, Xzg5^Qov
Xzg5, Xzg5^Qov, Xzg5, Xzg4^Qov, Xzg5, Xzg5, Xzg5, Xzg5^Es, Re, Xzg5^Edp, Rd, Rd, Rd, Rd, Xzg4, Rd, Xzg4^Esd, Re, Re, Xzg4^Qov, Xzg4^Qov, Xzg5^Qov, Xzg5^Qov, Xzg5^Qov, Xzg5^Qov, Xzg5^Qov, Xzg5^Qov, Dd, Dd, Dd, Dd, Dd, Xzg5^Qov, Dd, Dd, Dd, Xzg5^Qov, Dd^Edp, Dd, Dd^Edp, Dd, Dd, Re, Dd^Dc, Dd, Dd^Es, Dd^Es, Dd^Es, Dd, Dd, Dd, Dd, Dd, Dd, Xzg5^Qov, Xzgg^Qov
Rd, Xzg5, Xzg5^Es, Xzg5^Es, Re, Xzg5^Rusy, Re, Re, Rd, Re, Xzg4^Edp, Xzg4, Rd, Rd, Xzg4, Xzg4^Edp, Xzg4^Edp, Re, Re, Re, Xzg4, Xzg4^Qov, Xzg4^Qov, Xzg4^Qov, Xzg4^Qov, Xzg4^Qov, Xzg4^Qov, Xzg5^Qov, Xzg5^Qov, Xzg5^Qov, Xzg5^Qov, Dd, Xzg5^Qov, Xzg5^Qov, Xzg5^Qov, Xzg5^Qov, Xzg4^Qov, Xzg5^Qov, Dd, Dd, Rd, Rd, Dd, Dd^Es, Dd^Edp, Dd, Dd, Dd, Dd, Xzg5^Qov, Xzg5^Qov, Dd^Edp, Dd^Edp, Xzg5^Qov, Xzg5^Qov, Xzgg^Qov
Xzg4, Rd, Rd, Rd, Xzg4, Rd, Xzg4, Re, Xzg4, Xzg4^Es, Xzg4^Es, Xzg4, Xzg4^Edp, Re, Re, Xzg4, Xzg4, Xzg4, Xzg4, Rd, Rd, Rd, Rd, Xzg4, Re, Xzg4^Edp, Rd, Xzg4^Qov, Xzg4^Qov, Xzg4^Qov, Xzg4^Qov, Xzg5^Qov, Xzg4^Qov, Xzg5^Qov, Xzg4^Qov, Xzg4^Qov, Xzg4^Qov, Xzg5^Qov, Xzg5^Qov, Dd, Re, Dd, Dd, Dd^Edp, Dd^Edp, Dd, Xzg5^Qov, Xzg5^Qov, Xzg5^Qov, Xzg5^Qov, Dd, Dd^Edp, Dd^Edp, Dd, Xzg5^Qov, Xzgg^Qov
Xzg4^Edp, Xzg4^Edp, Xzg4, Xzg4, Dd^Qov, Xzg4, Dd^Qov, Xzg4^Edp, Xzg4, Xzg4^Rusy, Xzg4, Xzg4, Xzg4, Re, Xzg3, Xzg3^Qov, Xzg4, Dd^Qov, Dd^Qov, Xzg4^Es, Xzg4^Es, Xzg4^Es, Xzg4, Re, Rd, Re, Re, Re, Re, Xzg4, Rd, Xzg4^Qov, Re, Xzg4^Qov, Re, Re, Re, Xzg4^Qov, Re, Re, Re, Rd, Dd, Dd^Edp, Dd, Dd, Xzg5^Qov, Xzg5^Qov, Dd^Edp, Dd, Xzg5^Qov, Dd, Dd, Xzg5^Qov, Xzg3, Xzg3
Xzg4, Xzg4^Edp, Dd^Qov, Dd^Qov, Dd^Qov, Dd^Qov, Xzg5^Qov, Dd^Qov, Xzg4, Xzg4, Xzg4^Qov, Xzg3, Rd, Re, Xzg3, Xzg3^Qov, Xzg3^Qov, Xzg4, Xzg4, Xzg4, Xzg4^Es, Xzg4^Edp, Xzg4, Xzg4^Edp, Xzg4^Edp, Rd, Xzg4, Rd, Xzg4^Es, Rd, Xzg4, Re, Xzg4^Rusy, Re, Xzg4^Rusy, Re, Xzg4^Rusy, Rd, Rd, Re, Xzg4, Dd, Dd^Edp, Dd, Dd, Xzg5^Qov, Xzg5^Qov, Dd, Dd, Xzg5^Qov, Xzg3, Xzg5^Qov, Xzg5^Qov, Xzg5^Qov, Xzg3, Xzg3
Xzg4, Xzg4, Dd^Qov, Dd^Qov, Xzg2^Qov, Dd^Qov, Xzg4^Qov, Xzg5^Qov, Xzg4, Xzg4, Xzg5^Qov, Xzg3, Xzg3, Rd, Re, Xzg2^Qov, Xzg2^Qov, Xzg3^Qov, Xzg3^Qov, Xzg3^Qov, Xzg3^Qov, Xzg3^Qov, Xzg4, Xzg4^Edp, Xzg4^Edp, Xzg4, Xzg4^Edp, Xzg4^Es, Xzg4^Edp, Xzg4, Rd, Xzg4, Xzg4^Es, Xzg4, Xzg4, Xzg4^Rusy, Xzg4, Xzg4, Rd, Rd, Xzg4, Xzg5^Qov, Xzg5^Qov, Xzg5^Qov, Xzg5^Qov, Xzg5^Qov, Xzg4^Qov, Xzg5^Qov, Xzg5^Qov, Xzg5^Qov, Xzg3, Xzg3, Xzg3, Xzg3, Xzg3, Xzg3
Xzg4^Qov, Dd^Qov, Dd^Qov, Dd^Qov, Dd^Qov, Dd^Qov, Dd^Qov, Xzg4^Qov, Xzg4, Xzg4, Dd^Qov, Xzg5^Qov, Xzg3, Xzg3, Re, Xzg2, Rd, Xzg2^Qov, Xzg2^Qov, Xzg3, Xzg2^Qov, Xzg3^Qov, Xzg3^Qov, Xzg3^Qov, Xzg3^Qov, Xzg3^Qov, Xzg3^Qov, Xzg4^Edp, Xzg3^Qov, Xzg4, Re, Xzg4, Xzg4^Vdt, Xzg4, Xzg3^Qov, Xzg4, Dd^Qov, Xzg4, Xzg4, Xzg4^Edp, Xzg4^Edp, Xzg4^Qov, Xzg4^Qov, Xzg4^Qov, Xzg4^Qov, Xzg4^Qov, Xzg3^Qov, Xzg3^Qov, Xzg3, Xzg3, Xzg3, Xzg3, Xzg2^Qov, Xzg2^Qov, Xzg2^Qov, Xzg2^Qov
Xzg4, Xzg4^Qov, Dd^Qov, Dd^Qov, Dd^Qov, Dd^Qov, Dd^Qov, Xzg4, Xzg4^Qov, Dd^Qov, Dd^Qov, Xzg5^Qov, Xzg5^Qov, Xzg3, Xzg3, Re, Rd, Rd, Re, Xzg2^Qov, Rd, Xzg2^Qov, Xzg2^Qov, Xzg2^Qov, Xzg2^Qov, Xzg2^Qov, Xzg3^Qov, Xzg3^Qov, Xzg4^Edp, Xzg4^Vdt, Re, Re^Edp, Xzg4^Edp, Xzg4, Xzg3^Qov, Xzg4^Qov, Xzg4^Qov, Xzg4^Qov, Xzg3^Qov, Xzg4, Xzg3^Qov, Xzg4, Xzg4, Xzg4, Xzg3^Qov, Xzg3^Qov, Xzg2^Qov, Xzg3, Xzg2^Qov, Xzg2^Qov, Xzg2^Qov, Xzg2^Qov, Re, Xzg2, Rd, Xzg2
Xzg4, Xzg4^Qov, Dd^Qov, Dd^Qov, Xzg4^Qov, Dd^Qov, Xzg4^Qov, Xzg4, Dd^Qov, Dd^Qov, Dd^Qov, Dd^Qov, Xzg5^Qov, Xzg3, Xzg2^Qov, Xzg2, Xzg2^Es, Rd, Xzg2, Re, Xzg2, Rd, Xzg2, Xzg2^Edp, Xzg2^Edp, Xzg2, Xzg3^Qov, Xzg4, Xzg4^Edp, Rd, Xzg4, Xzg4, Xzg3^Qov, Xzg4, Xzg3^Qov, Xzg3^Qov, Xzg3^Qov, Xzg3^Qov, Xzg3, Xzg3^Qov, Xzg3^Qov, Xzg4, Xzg3^Qov, Xzg4, Xzg3^Qov, Xzg3^Qov, Xzg2, Xzg2^Qov, Xzg2^Vdt, Xzg2, Re, Re, Xzg2, Re, Re, Rd
Xzg4, Xzg4^Qov, Xzg4^Qov, Dd^Qov, Xzg4, Dd^Qov, Xzg4, Xzg4, Xzg5^Qov, Dd^Qov, Xzg5^Qov, Xzg5^Qov, Xzg2^Qov, Xzg3, Xzg2^Qov, Xzg2^Edp, Xzg2^Edp, Xzg2^Es, Xzg2^Es, Xzg2^Edp, Xzg2, Re, Re, Xzg2, Rd, Xzg2, Xzg2^Qov, Xzg3^Qov, Xzg4, Xzg4^Edp, Xzg3^Qov, Xzg3^Qov, Xzg2^Qov, Xzg3^Qov, Xzg2^Qov, Xzg3, Xzg2^Qov, Xzg3, Xzg2^Qov, Xzg2^Qov, Xzg2^Qov, Xzg3^Qov, Xzg3^Qov, Xzg3^Qov, Xzg3^Qov, Xzg2^Qov, Xzg2^Es, Re, Rd, Rd, Re, Xzg2, Xzg2^Edp, Re, Xzg2, Xzg2
Xzg2^Qov, Xzg4, Xzg2^Qov, Xzg4^Qov, Xzg4, Xzg4^Qov, Xzg4^Es, Xzg4^Es, Xzg2^Qov, Xzg5^Qov, Xzg2, Xzg2, Xzgg^Qov, Xzg2^Qov, Xzg2^Es, Xzg2^Es, Xzg2, Xzgg^Qov, Xzg2, Xzg2^Edp, Xzg2, Re, Xzg2, Re, Xzg2^Es, Rd, Xzg2, Xzg3^Qov, Xzg3^Qov, Xzg4, Xzg3^Qov, Xzg3^Qov, Xzg2, Xzg2^Qov, Xzg2, Xzg2^Qov, Xzg3^Qov, Xzg2^Qov, Xzg2^Es, Xzg2^Edp, Xzg2, Xzg2^Qov, Xzg2^Qov, Xzg2^Qov, Xzg2^Qov, Xzg2, Xzg2^Es, Rd, Xzg2, Xzg2, Xzg2^Es, Xzg2^Edp, Xzg2^Edp, Xzg2^Edp, Xzg2^Edp, Xzg2
Xzg5^Qov, Xzg2^Qov, Xzg5^Qov, Xzg2^Qov, Xzg2^Qov, Xzg2^Qov, Xzg2^Qov, Xzg4, Xzg2^Qov, Xzg2, Xzgg, Xzgg, Xzgg^Qov, Xzg2, Xzg2, Xzg2^Edp, Xzgg^Qov, Xzg2, Xzg2, Xzgg^Qov, Xzg2, Xzg2, Xzg2, Re, Re, Rd, Rd, Xzg2^Qov, Xzg2^Qov, Xzg3^Qov, Xzg2^Qov, Xzg2^Qov, Rd, Xzg2, Rd, Xzg2, Xzg2^Qov, Xzg2^Es, Xzg2^Es, Rd, Rd, Rd, Re, Re, Xzg2, Re, Xzg2, Xzg2, Xzg3^Qov, Xzg2, Xzg3^Qov, Xzg2, Xzg3^Qov, Xzg2^Es, Xzg2^Es, Xzg2
Xzg2, Xzg5^Qov, Xzg2, Xzg2, Xzg2^Edp, Xzg5^Qov, Xzg2, Xzg2^Qov, Xzg2, Xzg2, Xzgg, Xzg3, Xzgg, Xzgg^Qov, Xzgg^Qov, Xzgg^Qov, Xzgg^Qov, Xzg2^Vdt, Xzgg^Qov, Xzg2^Edp, Xzg2, Xzg4^Qov, Xzg4^Qov, Xzg2^Edp, Xzg2^Edp, Xzg2, Rd, Rd, Rd, Xzg2^Qov, Re, Rd, Re, Re, Xzg2, Rd, Re, Re, Rd, Rd, Rd, Rd, Xzg2, Xzg2, Xzg2, Xzg2, Xzg2, Xzg3^Qov, Xzg4, Xzg3^Qov, Xzg4, Xzg3^Qov, Xzg3^Qov, Xzg2, Xzg2, Xzg2
Xzg2, Xzg5^Qov, Xzg2, Xzg2, Xzg2, Xzg2, Xzg2, Xzgg, Xzgg, Xzgg, Xzgg, Xzgg, Xzg^Qov, Xzg^Qov, Xzg^Qov, Xzg^Qov, Xzg^Qov, Xzgg^Qov, Xzgg^Qov, Xzgg^Qov, Xzg2, Xzg4^Qov, Xzg4^Qov, Xzg2, Xzg4^Qov, Xzg2^Es, Xzg2, Re, Xzg2, Re, Xzg2, Rd, Xzg2^Edp, Rd, Xzg2^Es, Xzg2^Edp, Xzg2, Re, Rd, Xzg2, Xzg2^Edp, Xzg2, Xzg2^Es, Xzg2, Xzg3^Qov, Xzg3^Qov, Xzg3^Qov, Xzg3^Qov, Xzg4^Edp, Xzg4^Edp, Xzg4, Xzg4^Qov, Xzg3^Qov, Xzg2, Xzgg^Qov, Xzgg^Qov
Xzg2, Xzg2, Xzg2, Xzgg, Xzgg^Qov, Xzgg, Xzgg, Xzgg, Xzg^Qov, Xzg^Qov, Xzg^Qov, Xzg^Qov, Xzg, Xzg, Xzg^Edp, Xzg, Xzg^Edp, Xzg^Qov, Xzgg^Qov, Xzg2, Xzg4^Qov, Xzg4^Qov, Dd, Xzg4^Qov, Xzg2^Qov, Xzg2, Xzg4^Qov, Xzg2, Xzg4^Qov, Xzg2^Es, Xzg2^Vdt, Xzg2^Edp, Rd, Xzg2^Es, Xzg2, Rd^Es, Rd, Rd, Rd, Re, Xzg2^Vdt, Xzg2^Es, Xzg2, Xzg2, Xzg2^Qov, Xzg3, Xzg4^Edp, Xzg3, Xzg3, Xzg4^Es, Xzg3, Xzg3, Xzg2^Qov, Xzg2, Xzgg^Qov, Xzgg
Xzg2, Xzg2, Xzgg, Xzgg^Qov, Xzg^Qov, Xzg^Qov, Xzg^Qov, Xzgg^Qov, Xzg, Xzg, Xzg^Es, Xzg, Rd, Xzg, Xzg^Edp, Xzg^Edp, Xzg^Edp, Xzg, Xzgg^Qov, Xzg2^Qov, Xzg2^Qov, Xzg4, Xzg4^Qov, Xzg4, Xzg4, Xzg4^Qov, Dd, Xzg4^Qov, Xzg2^Qov, Xzg2^Edp, Xzg2, Xzg2^Edp, Xzg2, Rd, Xzg2^Edp, Rd, Xzg2, Re, Xzg2, Xzg2^Edp, Rd, Xzg2^Edp, Xzg2, Xzg3^Qov, Xzg3^Qov, Xzg3, Xzg3, Xzg4, Xzg3, Xzg3, Xzg2^Qov, Xzg3^Qov, Xzg2, Xzg2, Xzgg^Qov, Xzgg
Xzgg, Xzgg, Xzg^Qov, Xzgg^Qov, Xzg, Xzg, Rd, Xzg^Qov, Xzg, Xzg^Es, Xzg^Es, Rd^Es, Re, Re, Xzg, Xzg^Edp, Xzg^Vdt, Xzg, Xzg^Qov, Xzgg, Xzgg, Xzg2^Qov, Xzg2^Qov, Xzg2^Qov, Xzg2^Qov, Xzg4, Xzg4^Qov, Xzg4^Qov, Xzg2, Xzg2, Xzgg^Qov, Xzg2, Xzgg^Qov, Xzg2, Xzg2^Edp, Xzg2^Es, Xzg2^Es, Rd, Rd, Xzg2^Edp, Xzg2^Edp, Xzg2^Edp, Xzg2, Xzg2^Qov, Xzg2^Qov, Xzg3, Xzg2^Qov, Xzg3, Xzg2^Qov, Xzg3^Qov, Xzg2, Xzg2^Qov, Xzg2, Xzg2, Xzgg^Qov, Xzgg
Xzgg, Xzgg^Qov, Xzg^Qov, Xzgg^Qov, Xzg^Edp, Xzg^Edp, Xzg^Es, Rd, Re, Rd^Es, Rd, Rd, Re, Re, Re, Rd, Rd^Es, Xzg, Xzgg^Qov, Xzg^Qov, Xzgg, Xzgg, Xzg2, Xzg2, Xzg2, Xzg2^Qov, Xzg2^Qov, Xzg2^Qov, Xzgg^Qov, Xzgg^Qov, Xzgg, Xzgg^Qov, Xzgg^Qov, Xzg2, Xzg2, Rd, Rd, Rd, Rd, Xzg2, Xzg2, Xzg2^Edp, Xzgg^Qov, Xzg2, Xzg2, Xzg2^Qov, Xzg2, Xzg2^Qov, Xzg2, Xzg2^Qov, Xzg2, Xzg2, Xzgg^Qov, Xzgg^Qov, Xzgg, Xzgg
Xzg^Qov, Xzg^Qov, Xzg, Xzg^Qov, Xzg^Edp, Xzg, Rd, Rd, Rd, Re, Re, Re, Re, Re, Re, Rd^Es, Xzg, Xzg, Xzg^Qov, Xzgg^Qov, Xzg^Qov, Xzgg^Qov, Xzgg^Qov, Xzgg, Xzgg, Xzgg, Xzgg^Qov, Xzgg^Qov, Xzgg, Xzgg, Xzg^Qov, Xzg^Qov, Xzg^Qov, Xzgg^Qov, Xzg2, Xzg2^Es, Xzg2^Es, Rd, Xzgg, Rd, Rd, Xzgg^Qov, Xzgg, Xzgg^Qov, Xzgg^Qov, Xzg2, Xzgg^Qov, Xzg2, Xzgg^Qov, Xzg2, Xzg2, Xzg2, Xzgg^Qov, Xzgg, Xzg^Qov, Xzg^Qov
Xzg, Xzg, Xzg^Edp, Xzg, Xzg, Xzg, Re, Rd, Rd, Rd, Re, 1 Re, Re, Rd, Xzg, Xzg, Rd^Es, Xzg^Es, Xzg, Xzg^Qov, Xzg, Xzg^Qov, Xzg^Qov, Xzg^Qov, Xzg^Qov, Xzg^Qov, Xzg^Qov, Xzg^Qov, Xzg^Qov, Xzg^Qov, Xzg^Edp, Xzg^Edp, Xzg^Es, Xzgg^Qov, Xzgg^Qov, Xzg2, Xzgg^Qov, Xzgg, Xzgg^Es, Rd, Rd, Xzg^Qov, Xzg^Qov, Xzg^Qov, Xzg^Qov, Xzgg^Qov, Xzg^Qov, Xzgg^Qov, Xzgg, Xzgg^Qov, Xzgg^Qov, Xzgg^Qov, Xzgg^Qov, Xzg^Qov, Xzg^Edp, Xzg^Edp
Xzg, Xzg^Vdt, Xzg, Re^Es, Rd, Rd, Rd, Xzg^Edp, Xzg, Rd, Re, Re, Re, Re, Rd^Es, Rd, Xzg, Xzg^Edp, Xzg^Edp, Xzg, Rd, Xzg, Xzg, Xzg^Edp, Xzg^Edp, Xzg^Edp, Xzg, Xzg, Xzg, Xzg^Edp, Xzg, Xzg^Edp, Xzg^Edp, Xzg^Qov, Xzg^Qov, Xzgg^Qov, Xzg^Qov, Xzgg, Xzg^Qov, Xzgg, Rd, Xzg, Re, Xzg, Xzg^Edp, Xzg^Qov, Xzg, Xzg^Qov, Xzg^Qov, Xzg^Qov, Xzg^Qov, Xzg^Qov, Xzg^Qov, Xzg, Xzg^Edp, Xzg
Rd, Rd, Re, Re, Rd, Xzg, Xzg^Es, Xzg, Xzg, Rd, Rd^Es, Re, Xzg, Re, Rd, Xzg^Es, Xzg, Xzg, Re, Rd, Rd, Rd, Rd, Rd, Xzg^Edp, Xzg^Edp, Rd, Xzg, Rd, Rd, Re, Xzg, Rd, Xzg, Rd, Xzg^Qov, Xzg, Xzg^Qov, Xzg, Rd, Re, Re, Xzg, Xzg^Edp, Xzg^Edp, Xzg, Xzgg^Qov, Xzgg^Qov, Xzgg^Qov, Xzg, Xzg, Xzg, Xzg, Xzg, Xzgg^Qov, Xzg
Xzg^Edp, Xzg, Xzg^Edp, Rd, Xzg^Es, Xzg, Rd, Xzg, Rd, Rd, Rd, Xzg, Xzg^Edp, Re, Re, Rd^Es, Rd, Re, Re^Es, Rd, Xzg, Rd, Xzg, Xzg, Xzg^Es, Xzg^Edp, Rd^Es, Rd, Rd, Re, Rd, Re, Rd, Rd, Rd, Rd, Rd, Xzg, Xzg, Rd, Rd, Re, Xzg, Xzg^Edp, Xzg, Xzg^Edp, Xzg^Qov, Xzg^Qov, Xzg^Qov, Xzg, Xzg^Edp, Xzg^Edp, Xzg, Xzgg^Qov, Xzgg^Qov, Xzgg^Qov
Xzg, Xzg^Edp, Rd, Xzg, Rd^Es, Xzg^Es, Rd, Rd^Es, Xzg, Rd, Rd^Es, Xzg, Rd, Rd, Xzg, Re, Xzg, Xzg, Xzg, Xzg, Xzg^Es, Rd, Rd, Rd^Es, Rd, Rd, Xzg, Xzg, Xzg^Edp, Xzg, Xzg^Edp, Xzg, Xzg, Xzg, Xzg, Xzg, Xzg, Xzg, Xzg, Rd, Xzg, Re, Re, Xzg^Edp, Xzg^Es, Xzg, Xzg, Xzg, Xzg, Xzg, Re, Xzg, Xzg, Xzg^Qov, Xzg^Qov, Xzg^Qov
Rd, Rd, Xzg, Rd, Rd, Rd, Xzg, Xzg, Rd, Rd^Es, Xzg^Es, Rd, Rd, Xzg, Xzg, Xzg, Xzg^Edp, Xzg, Xzg, Xzg, Xzg, Xzg, Xzg^Vdt, Xzg, Xzg, Xzg^Edp, Xzg, Xzg, Xzg, Xzg^Edp, Xzgg^Qov, Xzg, Xzgg^Qov, Xzg, Xzgg^Qov, Xzg, Xzg, Rd, Xzg^Es, Xzg^Es, Xzg^Edp, Rd, Rd, Xzg, Re, Xzg, Re, Rd, Re, Re, Rd, Re, Re, Xzg, Xzg, Rd
Xzg, Rd, Xzg, Rd, Rd, 3 Xzg, Xzg^Edp, Rd, Rd^Es, Xzg, Rd, Xzg, Re, Rd, Xzg^Edp, Xzg^Edp, Xzg^Edp, Xzg, Xzg, Xzgg^Qov, Xzg, Xzg^Edp, Xzg, Xzg, Xzgg^Qov, Xzg, Xzgg^Qov, Xzgg^Qov, Xzgg^Qov, Xzgg^Qov, Xzgg, Xzgg^Qov, Xzg2, Xzgg^Qov, Xzgg, Xzgg^Qov, Xzgg^Qov, Xzg, Xzg, Xzg^Es, Xzg, Xzg^Edp, Xzg, Re, Rd, Re, Xzg, Re, Rd, Rd, Xzg, Xzg, Rd, Re, Xzg, Xzg^Edp
Xzg, Xzg, Rd, Rd, Rd, Xzg^Edp, Xzg^Edp, Xzg^Es, Rd, Rd, Rd, Re, Rd^Es, Xzg, Xzg^Edp, Xzg, Xzg, Xzg, Xzgg^Qov, Xzgg^Qov, Xzg, Xzg^Edp, Xzg, Xzgg^Qov, Xzgg, Xzgg^Qov, Xzg2, Xzgg, Xzg2, Xzg2, Xzg2, Xzg2, Xzg2^Edp, Xzg2, Xzg2^Edp, Xzgg, Xzg2, Xzgg^Qov, Xzgg^Qov, Xzgg^Qov, Xzgg^Qov, Xzg, Xzg, Xzg^Es, Xzg, Xzg, Xzg, Xzg^Vdt, Xzg, Xzg^Edp, Xzg^Edp, Xzg, Xzg^Edp, Rd, Rd, Rd
Rd, Rd, Xzg, Rd, Xzg, Xzg^Edp, Xzg^Edp, Xzg, Rd, Rd^Es, Xzg2^Es, Re, Rd, Xzg^Es, Xzg^Edp, Xzg^Edp, Xzg, Xzgg^Qov, Xzgg^Qov, Xzgg^Qov, Xzg, Xzg, Xzg, Xzgg^Qov, Xzgg, Xzg2, Xzg2, Xzg2, Xzg2, Xzg2, Xzg2, Xzg2^Edp, Xzg2, Xzg2^Edp, Xzg2, Xzg2^Edp, Xzg2, Xzg2, Xzgg, Xzgg^Qov, Xzgg, Xzg, Xzg, Xzg^Es, Xzgg, Xzgg^Qov, Xzgg, Xzg, Xzgg, Xzg, Xzg, Xzg^Edp, Xzg^Edp, Xzg, Rd, Rd
