Qxua, Qxua, Qxua, Qxua, Qxua, Qxua, Qxua, Qxua, Qxua, Qxua, Qxua, Qxua, Qxua, Qxua, Qxua, Qxua, Qxua, Qxua, Qxua, Qxua, Qxua, Qxua, Qxua, Qxua, Qxua, Qxua, Qxua, Qxua, Qxua, Qxua, Qxua, Qxua, Qxua, Qxua, Qxua, Qxua, Qxua, Qxua, Qxua, Qxua, Qxua, Qxua, Qxua, Qxua, Qxua, Qxua
Qxua, Qxua, Qxua, Qxua, Qxua, Qxua, Qxua, Qxua, Qxua, Qxua, Qxua, Qxua, Qxua, Qxua, Qxua, Qxua, Qxua, Qxua, Qxua, Qxua, Xzg3, Qxua, Xzg3, Xzg3, Xzg3, Qxua, Xzg3, Qxua, Xzg3, Qxua, Xzg3, Qxua, Qxua, Qxua, Qxua, Qxua, Qxua, Qxua, Qxua, Qxua, Qxua, Qxua, Qxua, Qxua, Qxua, Qxua
Qxua, Qxua, Qxua, Qxua, Qxua, Qxua, Qxua, Qxua, Qxua, Qxua, Qxua, Qxua, Xzg3, Qxua, Xzg3, Qxua, Qxua, Qxua, Xzg3, Xzg3, Xzg4, Xzg3, Xzg4^Es, Xzg4, Xzg4, Xzg3, Xzg4^Es, Xzg3, Xzg4, Xzg3, Xzg4, Xzg3, Qxua, Qxua, Qxua, Qxua, Qxua, Qxua, Qxua, Qxua, Qxua, Qxua, Qxua, Qxua, Qxua, Qxua
Qxua, Qxua, Qxua, Qxua, Qxua, Qxua, Qxua, Qxua, Qxua, Qxua, Qxua, Qxua, Xzg3, Xzg3^Es, Xzg4, Xzg3^Es, Xzg3, Xzg3, Xzg3, Xzg4, Xzg5^Xo, Xzg4^Es, Xzg4, Xzg5, Xzg4, Xzg4^Es, Xzg5, Xzg4^Es, Xzg5^Xo, Xzg4, Xzg4^Es, Xzg3, Xzg3, Qxua, Xzg3, Qxua, Qxua, Qxua, Qxua, Qxua, Qxua, Qxua, Qxua, Qxua, Qxua, Qxua
Qxua, Qxua, Qxua, Qxua, Qxua, Qxua, Qxua, Qxua, Qxua, Qxua, Qxua, Xzg3, Xzg3, Xzg4^Es, Xzg4, Xzg4, Xzg4, Xzg3, Xzg4, Xzg4, Xzg5^Xo, Xzg5^Es, Xzg5^Es, Xzg4, Xzg5^Xo, Xzg5^Xo, Xzg5^Xo, Xzg5^Xo, Xzg5^Xo, Xzg4, Xzg4^Es, Xzg3, Xzg3, Xzg3, Xzg3^Es, Xzg3, Xzg3, Qxua, Qxua, Qxua, Qxua, Qxua, Qxua, Qxua, Qxua, Qxua
Qxua, Qxua, Qxua, Qxua, Qxua, Qxua, Qxua, Qxua, Qxua, Qxua, Xzg3, Xzg3, Xzg4, Xzg4, Xzg5^Xo, Xzg5^Xo, Xzg5^Qov, Xzg4^Xo, Xzg5^Xo, Xzg5^Xo, Dd, Xzg5^Xo, Xzg5^Xo, Xzg5^Xo, Xzg5^Xo, Dd, Dd, Xzg5^Xo, Dd, Xzg5^Xo, Xzg4, Xzg4^Es, Xzg4^Es, Xzg4, Xzg4, Xzg4, Xzg3, Qxua, Qxua, Qxua, Qxua, Qxua, Qxua, Qxua, Qxua, Qxua
Qxua, Qxua, Qxua, Qxua, Qxua, Qxua, Qxua, Qxua, Xzg3, Qxua, Xzg3, Xzg3, Xzg4, Xzg5^Xo, Dd, Xzg5^Xo, Dd^Xo, Xzg5^Xo, Dd^Xo, Xzg5^Xo, Dd, Xzg5^Xo, Dd, Dd, Dd, Dd, Re^Rusy, Dd, Dd, Xzg5^Xo, Xzg5^Xo, Xzg4, Xzg5^Xo, Xzg5^Xo, Xzg5^Es, Xzg4, Xzg3, Xzg3, Xzg3, Qxua, Xzg3, Qxua, Qxua, Qxua, Qxua, Qxua
Qxua, Qxua, Qxua, Qxua, Qxua, Xzg3, Xzg3, Xzg3, Xzg4^Es, Xzg3, Xzg4, Xzg3^Es, Xzg4, Xzg5^Xo, Dd, Dd^Es, Dd^Xo, Dd^Xo, Dd^Xo, Dd, Dd, Dd, Dd^Rusy, Dd, Dd^Rusy, Rd, Re, Re^Rusy, Re, Dd, Dd, Xzg5^Xo, Dd, Xzg5^Xo, Xzg5^Xo, Xzg4^Es, Xzg4, Xzg3^Es, Xzg4, Xzg3, Xzg3, Qxua, Qxua, Qxua, Qxua, Qxua
Qxua, Qxua, Qxua, Qxua, Qxua, Qxua, Xzg3, Xzg3, Xzg4, Xzg4^Es, Xzg4, Xzg4^Es, Xzg5^Es, Xzg5^Xo, Xzg5^Xo, Dd^Es, Dd^Xo, Dd^Ruty, Rd^Xo, Rd, Rd, Dd^Rusy, Rd, Rd, Rd, Rd, Re, Re, Rd, Re, Dd, Dd, Dd, Xzg5^Xo, Xzg4, Xzg4, Xzg5, Xzg4, Xzg5, Xzg4, Xzg3, Qxua, Qxua, Qxua, Qxua, Qxua
Qxua, Qxua, Qxua, Qxua, Xzg3, Xzg3, Xzg3, Xzg4^Es, Xzg4, Xzg5, Xzg4, Xzg5^Xo, Dd, Xzg5^Xo, Xzg5^Xo, Dd, Rd, Dd^Xo, Rd^Rusy, Dd^Rusy, Dd, Re, Re, Rd, Rd, Dd, Dd, Dd^Rusy, Rd, Re, Dd^Rusy, Dd, Xzg5^Xo, Xzg5^Xo, Xzg4, Xzg5^Es, Xzg5, Xzg4, Xzg4, Xzg4, Xzg3, Qxua, Qxua, Qxua, Qxua, Qxua
Qxua, Qxua, Qxua, Qxua, Xzg3^Es, Xzg3, Xzg4^Es, Xzg4, Xzg5^Xo, Xzg4, Xzg5^Xo, Xzg5^Xo, Dd, Xzg5^Xo, Dd, Dd, Rd^Rusy, Rd, Re, Rd, Re, Re, Rd, 2 Re, Rd, Rd, Dd, Dd^Rusy, Dd^Rusy, Dd^Rusy, Dd^Es, Dd, Xzg5^Xo, Xzg5^Xo, Xzg4, Xzg4, Xzg4, Xzg4, Xzg4, Xzg3, Xzg3^Es, Xzg3, Xzg3, Qxua, Qxua, Qxua
Qxua, Qxua, Qxua, Xzg3, Xzg3^Es, Xzg4, Xzg5^Xo, Xzg5^Xo, Dd, Xzg5^Xo, Dd, Xzg5^Xo, Xzg5^Xo, Xzg5^Xo, Dd^Es, Rd, Rd^Rusy, Rd, Dd, Re, Re, Rd, Rd, Rd, Rd, Re, Re, Dd, Dd^Es, Dd^Es, Dd, Dd, Xzg5^Xo, Xzg4, Xzg5^Xo, Xzg4, Xzg5^Xo, Xzg4^Es, Xzg4, Xzg3^Es, Xzg4, Xzg3, Xzg3, Qxua, Qxua, Qxua
Qxua, Qxua, Qxua, Xzg3, Xzg3, Xzg4^Es, Xzg5^Xo, Xzg5^Xo, Dd, Dd, Rd, Dd, Dd^Es, Dd, Dd^Es, Dd^Rusy, Dd, Rd^Es, Re, Rd, Re, Re, Dd, Rd, Dd, Re, Rd^Rusy, Re^Rusy, Rd, Dd^Es, Dd, Xzg5^Xo, Dd^Xo, Xzg5^Xo, Xzg5^Xo, Xzg5^Xo, Dd, Xzg5^Xo, Xzg5^Xo, Xzg4^Es, Xzg4, Xzg4, Xzg3, Qxua, Qxua, Qxua
Qxua, Qxua, Xzg3, Xzg3, Xzg4, Xzg4^Es, Xzg5^Xo, Dd, Dd, Rd^Es, Dd^Es, Dd^Es, Re, Dd^Es, Rd, Dd^Rusy, Rd^Es, Rd^Es, Rd, Rd, Rd^Rusy, Rd^Es, Dd^Rusy, Rd, Dd^Es, Dd, Re, Re, Re, Dd, Dd^Es, Dd^Xo, Rd^Ruty, Dd^Xo, Dd^Es, Dd, Dd, Dd, Dd, Xzg5^Xo, Xzg5^Xo, Xzg4, Xzg3, Qxua, Qxua, Qxua
Qxua, Qxua, Xzg3, Xzg4, Xzg4, Xzg5^Xo, Xzg5^Xo, Xzg5^Xo, Dd, Dd, Dd^Rusy, Dd, Re, Rd, Rd, Dd, Rd, Rd, Re, Dd^Es, Dd^Rusy, Dd^Es, Dd^Rusy, Dd^Es, Dd, Rd, Rd, Re, Re^Rusy, Rd^Rusy, Dd^Es, Dd^Xo, Dd^Xo, Dd^Xo, Dd, Dd^Es, Dd, Xzg5^Xo, Xzg5^Xo, Xzg5^Xo, Xzg5^Xo, Xzg4, Xzg3, Qxua, Qxua, Qxua
Qxua, Qxua, Qxua, Xzg3, Xzg4, Xzg4, Xzg5^Xo, Xzg5^Xo, Dd, Dd, Dd^Rusy, Rd, Dd, Re, Re, Rd^Es, Rd, Dd^Es, Re^Rusy, Dd^Rusy, Dd^Rusy, Dd^Rusy, Dd^Rusy, Dd^Rusy, Dd^Rusy, Rd^Rusy, Rd, Re, Re, Re, Rd, Rd, Rd, Rd^Rusy, Dd, Dd, Xzg5^Xo, Xzg5^Xo, Xzg5^Xo, Xzg5^Xo, Xzg4, Xzg4, Xzg4, Xzg3, Qxua, Qxua
Qxua, Qxua, Xzg3, Xzg3^Es, Xzg4^Es, Xzg5^Xo, Xzg5^Xo, Dd, Dd, Dd^Es, Rd, Dd^Es, Dd, Dd, Rd, Rd, Dd, Re, Re^Rusy, Dd^Rusy, Dd^Es, Dd^Rusy, Dd^Rusy, Dd^Rusy, Dd^Rusy, Dd^Es, Rd^Rusy, Rd, Rd, Re, Re, Rd, Rd, Dd, Dd, Xzg5^Xo, Xzg5^Xo, Dd, Xzg5^Xo, Xzg4, Xzg4, Xzg4, Xzg3, Xzg3, Qxua, Qxua
Qxua, Xzg3, Xzg3^Es, Xzg4, Xzg5^Xo, Xzg5^Xo, Dd, Dd, Dd, Rd, Re^Xo, Dd^Xo, Dd^Xo, Dd, Dd^Rusy, Dd^Rusy, Dd, Re, Re, Re^Es, Dd, Dd^Rusy, Dd^Rusy, Dd^Rusy, Dd^Rusy, Dd^Rusy, Dd, Dd, Rd, Rd^Es, Rd^Es, Dd, Dd, Dd, Dd, Dd, Xzg5^Xo, Dd, Xzg5^Xo, Xzg4, Xzg4, Xzg3, Qxua, Qxua, Qxua, Qxua
Qxua, Xzg3, Xzg3, Xzg4, Xzg4, Xzg5^Xo, Xzg5^Xo, Xzg5^Xo, Dd, Dd, Rd^Xo, Dd^Xo, Dd^Xo, Dd^Rusy, Rd, Dd, Dd, Dd, Rd, Dd, Dd^Rusy, Dd^Rusy, Dd^Rusy, Rd, Rd, Rd, Dd, Rd, Re, Re, Rd^Rusy, Dd^Es, Rd, Dd, Rd^Rusy, Dd, Dd, Xzg5^Xo, Xzg5^Xo, Xzg5^Xo, Xzg4, Xzg3, Qxua, Qxua, Qxua, Qxua
Qxua, Qxua, Xzg3, Xzg3, Xzg4, Xzg5^Es, Xzg5^Xo, Xzg5^Xo, Xzg5^Xo, Dd, Dd^Xo, Dd^Ruty, Dd^Xo, Dd, Rd, Rd, Re, Rd, Rd, Dd, Re, Dd, Dd, Dd^Rusy, Dd, Rd, Re, Re, Re^Rusy, Re^Rusy, Dd^Es, Dd^Es, Rd^Es, Rd, Rd^Es, Dd^Es, Dd, Dd, Xzg5^Xo, Xzg5^Xo, Xzg4, Xzg3, Qxua, Qxua, Qxua, Qxua
Qxua, Qxua, Xzg3, Xzg3, Xzg4, Xzg5^Xo, Dd, Xzg5^Xo, Dd, Dd, Dd^Es, Dd^Xo, Dd, Re, Rd, Re, Dd^Es, Re, Dd, Re, Dd, Re, Rd, Rd, Rd, Re, Dd, Dd, Dd^Rusy, Re^Rusy, Dd^Rusy, Rd^Es, Rd^Es, Rd, Dd, Dd, Dd, Xzg5^Xo, Xzg4, Xzg4, Xzg3, Xzg3, Qxua, Qxua, Qxua, Qxua
Qxua, Xzg3, Xzg4, Xzg4^Es, Xzg5^Xo, Xzg5^Xo, Dd, Dd, Dd^Rusy, Rd^Es, Re, Re, Dd, Rd, Dd^Es, Rd^Es, Dd, Dd, Dd^Rusy, Dd^Rusy, Re, Re, Rd, Rd, Rd, Re, Re, Dd, Rd, Dd^Rusy, Dd, Dd, Dd, Dd, Dd, Xzg5^Xo, Xzg5^Xo, Xzg5^Xo, Xzg4, Xzg4, Xzg3, Xzg3, Qxua, Qxua, Qxua, Qxua
Qxua, Xzg3^Es, Xzg4, Xzg4, Xzg5^Xo, Dd, Dd, Dd, Dd, Rd, Rd^Es, Re, Re, Dd^Rusy, Dd^Rusy, Dd^Rusy, Dd^Rusy, Dd^Rusy, Dd^Rusy, Re, Re^Rusy, Re, Rd, 1 Rd^Es, Rd, Re, Rd, Dd^Es, Dd^Es, Rd, Dd, Dd, Xzg5^Xo, Dd, Xzg5^Xo, Dd, Xzg5^Xo, Xzg5^Xo, Xzg4, Xzg3, Xzg3, Qxua, Qxua, Qxua, Qxua, Qxua
Qxua, Xzg3^Es, Xzg4^Es, Xzg4, Xzg5^Xo, Dd, Xzg5^Xo, Dd, Xzg5^Xo, Dd, Dd, Dd^Es, Re, Re, Dd, Dd^Rusy, Dd^Rusy, Dd^Rusy, Dd^Rusy, Dd^Rusy, Re^Rusy, Rd^Rusy, Re, Re^Es, Rd, Rd, Rd, Rd, Dd^Es, Rd, Rd, Dd, Xzg5^Xo, Xzg5^Xo, Xzg5^Xo, Xzg5^Xo, Xzg5^Es, Xzg5^Es, Xzg4^Es, Xzg3, Xzg3, Qxua, Qxua, Qxua, Qxua, Qxua
Qxua, Xzg3, Xzg3, Xzg4, Xzg4, Xzg5^Xo, Xzg4, Xzg5^Xo, Xzg4, Xzg5^Xo, Xzg5^Xo, Dd, Dd, Rd, Dd^Es, Dd^Rusy, Dd, Dd^Rusy, Dd^Es, Rd^Es, Rd, Re^Rusy, Rd, Rd, Dd^Es, Rd^Es, Dd^Es, Dd^Es, Dd^Es, Dd^Es, Dd, Dd, Dd, Xzg5^Xo, Xzg4, Xzg4, Xzg4^Es, Xzg4, Xzg5^Es, Xzg4, Xzg3, Xzg3, Qxua, Qxua, Qxua, Qxua
Qxua, Qxua, Xzg3, Xzg4, Xzg4, Xzg4, Xzg4^Es, Xzg4, Xzg4, Xzg4, Xzg5^Xo, Dd, Dd, Dd, Dd, Dd, Xzg5^Xo, Dd, Dd, Dd, Rd, Dd, Dd^Es, Dd, Dd, Dd, Dd, Dd, Xzg5^Xo, Dd, Dd, Dd, Xzg5^Xo, Xzg5^Xo, Xzg4, Xzg4^Es, Xzg4, Xzg4^Es, Xzg4, Xzg4, Xzg3, Xzg3, Qxua, Qxua, Qxua, Qxua
Qxua, Qxua, Qxua, Xzg3, Xzg3^Es, Xzg3^Es, Xzg3, Xzg4^Es, Xzg4^Es, Xzg4^Es, Xzg5^Xo, Xzg5^Xo, Dd, Dd, Dd, Dd, Xzg5^Xo, Dd, Dd, Rd, Rd, Dd, Dd, Dd^Es, Dd, Dd, Xzg5^Xo, Dd, Xzg5^Xo, Xzg5^Xo, Dd, Dd, Xzg5^Xo, Xzg4, Xzg4^Es, Xzg3^Es, Xzg3^Es, Xzg3, Xzg3, Xzg3, Xzg3, Qxua, Qxua, Qxua, Qxua, Qxua
Qxua, Qxua, Qxua, Qxua, Xzg3, Xzg3, Xzg3, Xzg3, Xzg4, Xzg4^Es, Xzg5^Xo, Xzg5^Xo, Xzg5^Xo, Xzg5^Xo, Xzg5^Xo, Xzg5^Xo, Xzg5^Xo, Xzg5^Xo, Xzg5^Xo, Dd, Dd, Dd, Xzg5^Xo, Xzg5^Xo, Xzg5^Xo, Xzg5^Xo, Xzg5^Xo, Xzg5^Xo, Xzg5^Xo, Xzg5^Xo, Xzg5^Xo, Xzg5^Xo, Xzg4, Xzg4, Xzg4, Xzg3, Xzg3, Xzg3^Es, Qxua, Xzg3, Xzg3, Qxua, Qxua, Qxua, Qxua, Qxua
Qxua, Qxua, Qxua, Qxua, Qxua, Qxua, Qxua, Xzg3, Xzg3, Xzg4^Es, Xzg4, Xzg5^Es, Xzg4, Xzg4, Xzg4, Xzg4, Xzg4, Xzg5^Xo, Xzg5^Xo, Dd, Dd, Xzg5^Xo, Dd, Dd, Xzg5^Es, Xzg4, Xzg4^Es, Xzg4, Xzg4^Es, Xzg4, Xzg4, Xzg4, Xzg3, Xzg3, Xzg3, Xzg3, Xzg3, Qxua, Qxua, Qxua, Qxua, Qxua, Qxua, Qxua, Qxua, Qxua
Qxua, Qxua, Qxua, Qxua, Qxua, Qxua, Qxua, Xzg3, Xzg3^Es, Xzg4, Xzg4^Es, Xzg4^Es, Xzg4, Xzg5, Xzg5, Xzg5, Xzg5, Xzg4, Xzg5^Xo, Xzg5^Xo, Xzg5^Xo, Xzg5^Xo, Xzg5^Xo, Xzg5^Xo, Xzg5^Xo, Xzg4^Es, Xzg5, Xzg5^Es, Xzg4, Xzg4^Es, Xzg4, Xzg3, Qxua, Xzg3, Qxua, Xzg3, Qxua, Qxua, Qxua, Qxua, Qxua, Qxua, Qxua, Qxua, Qxua, Qxua
Qxua, Qxua, Qxua, Qxua, Qxua, Qxua, Xzg3, Xzg3, Xzg3^Es, Xzg3^Es, Xzg3^Es, Xzg4^Es, Xzg4^Es, Xzg4, Xzg4^Es, Xzg4^Es, Xzg4, Xzg4, Xzg4, Xzg5^Xo, Xzg4, Xzg5^Xo, Xzg4, Xzg4, Xzg4^Es, Xzg4, Xzg4, Xzg4, Xzg3, Xzg4, Xzg3, Xzg3, Qxua, Qxua, Qxua, Qxua, Qxua, Qxua, Qxua, Qxua, Qxua, Qxua, Qxua, Qxua, Qxua, Qxua
Qxua, Qxua, Qxua, Qxua, Qxua, Xzg3, Xzg3, Xzg3, Qxua, Xzg3, Xzg3, Xzg3, Xzg3^Es, Xzg3^Es, Xzg3, Xzg4, Xzg3^Es, Xzg4^Es, Xzg4, Xzg4, Xzg5, Xzg4, Xzg4^Es, Xzg4, Xzg3^Es, Xzg4^Es, Xzg3, Xzg3, Xzg3, Xzg3, Xzg3, Xzg3, Qxua, Qxua, Qxua, Qxua, Qxua, Qxua, Qxua, Qxua, Qxua, Qxua, Qxua, Qxua, Qxua, Qxua
Qxua, Qxua, Qxua, Qxua, Qxua, Qxua, Qxua, Qxua, Qxua, Qxua, Qxua, Xzg3, Xzg3, Xzg3, Xzg3, Xzg3, Xzg3, Xzg3, Xzg3, Xzg4, Xzg4^Es, Xzg4^Es, Xzg4, Xzg3^Es, Xzg3, Xzg3, Xzg3, Xzg3, Qxua, Qxua, Qxua, Qxua, Qxua, Qxua, Qxua, Qxua, Qxua, Qxua, Qxua, Qxua, Qxua, Qxua, Qxua, Qxua, Qxua, Qxua
Qxua, Qxua, Qxua, Qxua, Qxua, Qxua, Qxua, Qxua, Qxua, Qxua, Qxua, Qxua, Qxua, Qxua, Qxua, Qxua, Qxua, Xzg3, Xzg3, Xzg3, Xzg3, Xzg3, Xzg3, Xzg3, Qxua, Qxua, Qxua, Qxua, Qxua, Qxua, Qxua, Qxua, Qxua, Qxua, Qxua, Qxua, Qxua, Qxua, Qxua, Qxua, Qxua, Qxua, Qxua, Qxua, Qxua, Qxua
Qxua, Qxua, Qxua, Qxua, Qxua, Qxua, Qxua, Qxua, Qxua, Qxua, Qxua, Qxua, Qxua, Qxua, Qxua, Qxua, Qxua, Qxua, Qxua, Qxua, Qxua, Qxua, Qxua, Qxua, Qxua, Qxua, Qxua, Qxua, Qxua, Qxua, Qxua, Qxua, Qxua, Qxua, Qxua, Qxua, Qxua, Qxua, Qxua, Qxua, Qxua, Qxua, Qxua, Qxua, Qxua, Qxua
