Dd^Es, Dd, Dd^Es, Dd, Dd, Dd, Rd, Dd, Re, Rd, Rd, Dd, Dd, Dd, Dd, Dd, Dd, Dd, Dd, Dd, Dd, Dd, Dd, Dd, Dd^Es, Dd^Edp, Dd, Rd, Dd, Dd, Dd^Edp, Dd, Dd, Dd, Dd, Dd, Dd, Dd, Xzg5, Dd, Dd, Xzg5^Qov, Xzg4, Xzg4, Xzg4, Xzg4, Xzg3, Xzg3, Xzg3, Xzg3, Rd, Xzg3, Rd, Xzg3, Xzg3, Xzg3, Xzg3, Xzg3, Xzg3
Dd, Dd^Es, Dd^Es, Dd, Dd, Dd, Re, Re, Dd^Edp, Re, Dd, Dd, Dd^Es, Dd, Dd^Es, Dd^Edp, Dd^Edp, Dd^Edp, Dd, Dd, Dd^Es, Dd, Dd, Dd^Es, Dd^Edp, Dd^Edp, Dd, Rd, Rd, Rd, Dd, Dd^Edp, Dd^Edp, Dd^Edp, Dd^Edp, Dd, Dd, Xzg5, Dd, Dd, Dd^Es, Xzg5^Qov, Xzg5^Qov, Xzg4, Xzg4, Xzg3, Xzg3, Xzg3, Xzg3^Edp, Xzg3, Rd, Rd, Rd, Xzg3^Es, Xzg3^Edp, Xzg3, Xzg3, Xzg3, Xzg3
Dd, Dd^Es, Dd^Es, Dd, Re, Re, Dd, Dd^Edp, Dd, Dd^Edp, Dd^Es, Dd, Dd^Es, Dd^Es, Dd^Edp, Dd^Edp, Dd^Es, Dd^Edp, Dd^Es, Dd^Es, Dd, Dd^Es, Dd, Dd^Edp, Dd^Edp, Dd^Edp, Rd, Rd, Dd, Dd^Edp, Dd^Edp, Dd^Edp, Re, Dd^Es, Rd, Dd, Dd^Es, Dd, Dd^Edp, Dd^Es, Dd^Es, Dd, Xzg5^Qov, Xzg5, Xzg4, Xzg3, Xzg3, Xzg3^Edp, Xzg3, Xzg3, Re, Re, Rd, Xzg3, Xzg3, Re, Re, Re, Xzg3
Dd, Dd, Dd, Dd, Dd, Re, Re, Dd^Edp, Dd^Edp, Dd^Es, Dd^Es, Dd^Es, Dd^Es, Dd, Dd, Dd^Edp, Dd, Dd^Es, Dd, Dd^Es, Dd^Es, Dd, Re, Re, Re, Dd, Dd, Dd, Dd, Dd, Dd, Dd, Re, Dd^Edp, Re, Rd, Dd^Es, Dd^Edp, Dd^Edp, Xzg5, Dd, Xzg5^Qov, Xzg4, Xzg4, Xzg4, Xzg4, Xzg3, Xzg3^Es, Xzg3, Rd, Xzg3, Re, Re, Re, Re, Re, Xzg3^Es, Xzg3, Xzg3
Dd, Rd, Rd, Re, Re, Rd, Dd, Dd, Dd, Dd, Dd, Dd^Es, Dd, Dd, Dd, Dd^Edp, Dd, Dd, Dd, Dd, Dd, Dd, Dd, Re, Re^Es, Re, Re, Rd, Rd, Rd, Rd, Rd, Rd, Re, Re, Rd, Dd, Dd^Edp, Dd^Edp, Dd, Dd, Xzg5^Qov, Xzg5^Edp, Xzg4^Edp, Xzg4, Xzg3, Xzg3, Xzg3^Edp, Re, Re, Re, Re, Xzg3^Es, Xzg3^Es, Xzg3, Re, Xzg3, Xzg3^Es, Xzg3
Dd^Es, Dd, Dd, Dd, Dd, Rd, Re, Dd, Re, Dd, Dd, Dd^Edp, Dd, Dd^Es, Dd, Dd, Dd, Dd, Dd, Dd, Dd, Rd, Rd, Re^Es, Rd, Rd, Rd, Rd, Rd, Dd, Re, Dd, Re, Re^Es, Re, Dd, Rd, Dd, Dd^Es, Dd, Dd, Xzg5^Qov, Xzg5^Qov, Xzg4, Xzg4, Xzg3, Xzg3, Xzg3^Es, Xzg3^Edp, Rd, Xzg3^Es, Re, Re, Re, Re, Re, Xzg3, Xzg3^Edp, Xzg3
Rd, Dd^Es, Dd, Dd, Dd, Rd, Rd, Re, Re, Rd, Dd^Edp, Dd^Edp, Dd, Dd^Es, Dd, Dd, Dd, Rd, Rd, Dd, Dd, Dd, Re, Re, Re, Rd, Rd, Dd, Dd^Es, Dd^Es, Re, Re, Re^Es, Rd, Dd, Re, Dd, Rd, Dd, Dd^Edp, Dd^Edp, Dd, Dd, Xzg5^Qov, Xzg4, Xzg4, Xzg3, Xzg3^Edp, Xzg3, Xzg3^Es, Xzg3, Xzg3, Xzg3, Xzg3^Es, Xzg3, Xzg3^Es, Xzg3^Edp, Xzg3^Edp, Xzg3
Rd, Dd, Rd, Rd, Re, Dd, Dd^Edp, Dd^Edp, Re, Re, Re, Dd^Edp, Dd, Dd, Re, Dd, Dd, Rd, Re, Rd, Dd, Rd, Dd, Rd, Dd, Dd^Es, Dd, Dd^Es, Dd, Rd, Rd, Rd, Re^Es, Re, Dd^Es, Dd^Edp, Dd^Edp, Dd^Edp, Dd^Edp, Dd, Dd, Dd, Dd, Xzg5^Qov, Xzg5^Qov, Xzg4, Xzg4^Edp, Xzg3, Xzg3, Xzg3, Xzg4, Xzg3, Xzg3, Xzg3^Edp, Xzg3, Xzg3, Xzg3, Xzg3, Xzg3
Dd, Rd, Dd, Dd, Rd, Re, Re^Edp, Dd^Edp, Dd^Edp, Re, Re^Es, Rd, Rd, Rd, Re, Re, Re, Re, Dd, Rd, Rd, Dd, Dd, Dd, Dd, Dd, Dd, Dd, Rd, Dd, Rd, Re, Dd, Rd, Dd^Es, Dd^Edp, Dd, Dd^Es, Dd^Edp, Dd^Edp, Dd^Edp, Rd^Es, Dd, Dd, Xzg5^Qov, Xzg4, Xzg4, Xzg4, Xzg4, Xzg4, Xzg5^Qov, Xzg4, Xzg4, Xzg3, Xzg4, Xzg3, Xzg4, Xzg3, Xzg3
Dd, Dd, Dd, Dd, Dd, Rd, Rd, Dd^Edp, Dd, Rd, Rd^Es, Rd, Dd, Re, Re, Dd, Dd, Re, Dd, Dd, Dd, Dd, Dd, Dd, Dd^Es, Dd^Es, Rd, Re, Re, Rd, Dd, Dd, Dd, Dd, Re, Re, Rd, Rd, Dd^Edp, Dd^Edp, Dd^Es, Rd, Rd, Dd, Dd, Xzg5^Qov, Xzg5^Qov, Xzg5^Qov, Xzg5^Qov, Xzg5^Qov, Dd, Xzg5^Qov, Xzg5^Qov, Xzg4, Xzg5^Qov, Xzg4, Xzg5^Qov, Xzg4, Xzg4
Dd, Dd, Dd^Es, Dd^Edp, Dd, Dd, Dd, Rd, Rd, Rd, Re, Dd, Dd, Dd, Rd, Rd, Dd, Dd, Dd, Dd, Dd, Dd, Dd, Dd, Dd, Dd, Dd, Re, Re, Rd, Dd, Dd^Es, Dd^Edp, Rd, Rd, Dd, Dd, Dd, Dd^Edp, Dd, Dd, Dd, Dd^Es, Dd^Es, Dd, Dd, Dd, Dd, Dd, Dd, Re, Dd, Dd, Xzg5^Qov, Dd, Xzg5^Qov, Dd, Xzg5^Qov, Xzg5^Qov
Dd, Dd, Dd, Rd, Dd^Edp, Dd^Edp, Dd^Edp, Dd, Dd, Rd, Dd, Re, Re, Rd, Dd, Re, Dd, Dd^Es, Dd, Dd, Dd, Dd, Dd, Dd, Dd, Dd, Dd, Re, Re, Rd, Dd^Edp, Dd, Dd^Es, Re, Rd, Dd, Re, Re, Rd, Dd, Rd, Re, Re, Dd, Re, Dd^Es, Dd^Es, Dd^Es, Dd, Re, Dd, Rd, Dd, Dd, Dd, Dd, Xzg5, Dd, Dd
Xzg5^Qov, Dd, Dd, Rd, Rd, Rd, Dd, Dd, Dd, Dd, Dd, Rd, Re, Rd, Re, Re, Dd, Dd^Es, Dd, Dd, Dd, Dd, Dd, Dd, Dd, Dd, Dd^Edp, Dd, Dd, Dd, Dd, Dd, Dd^Edp, Dd^Edp, Dd^Edp, Re, Re, Re, Dd^Es, Rd, Dd, Re, Dd, Re, Rd, Dd, Dd, Dd, Rd, Re, Rd, Rd, Rd, Dd^Es, Dd^Es, Dd, Dd, Dd, Dd
Xzg5^Qov, Dd, Dd, Re, Re^Es, Dd, Re, Dd, Dd^Edp, Dd, Rd, Rd, Re, Re, Rd, Re, Rd, Dd, Dd, Dd, Rd, Dd, Re, Re, Re, Dd, Dd, Dd, Dd, Dd, Re, Re^Es, Dd, Dd^Edp, Dd, Dd, Rd, Dd, Dd, Dd^Es, Dd, Dd^Es, Rd, Dd, Dd, Dd, Rd, Dd, Rd, Re^Es, Dd, Re^Es, Dd, Dd, Dd, Dd, Dd, Dd^Edp, Dd^Edp
Xzg5, Xzg5^Qov, Xzg5^Qov, Dd, Dd, Re^Es, Dd, Dd^Edp, Dd, Dd, Dd, Dd, Dd, Re, Re^Es, Re, Re, Dd, Dd, Re, Re, Rd, Dd, Re, Dd, Rd, Dd, Dd, Dd, Rd, Rd, Re, Re, Rd, Dd, Dd, Dd, Rd, Rd, Dd^Es, Dd, Rd, Rd, Dd, Rd^Es, Rd, Rd, Re, Dd^Edp, Dd, Rd, Dd, Dd^Edp, Dd^Edp, Dd^Edp, Dd, Dd, Dd, Dd
Xzg5, Xzg5^Qov, Dd, Dd, Re, Rd, Re, Dd, Dd^Edp, Dd^Es, Dd, Rd, Re, Re^Es, Rd, Rd, Re, Re, Re, Re, Dd, Rd, Dd, Dd, Dd, Rd, Dd, Dd, Dd, Dd, Rd, Re, Re, Re, Rd, Dd, Rd, Rd, Rd, Re, Re, Re, Rd, Rd, Rd^Es, Dd^Es, Dd, Dd, Dd^Edp, Dd, Rd, Dd, Re, Re, Dd^Edp, Rd^Es, Dd, Dd, Dd
Xzg4, Xzg5^Qov, Xzg5^Qov, Dd, Dd, Re, Rd, Dd, Dd^Es, Dd^Es, Dd^Edp, Dd^Edp, Rd, Rd, Dd, Rd, Rd, Dd, Dd, Dd, Dd, Dd, Dd, Dd, Rd, Rd, Dd, Rd, Rd, Rd, Dd, Rd, Re, Rd, Re, Rd, Rd, Dd, Dd, Dd, Re, Re, Re, Rd, Re, Dd, Dd, Dd, Dd, Dd^Edp, Dd, Re, Re, Rd, Dd^Edp, Dd^Es, Dd^Edp, Rd, Rd
Xzg4, Xzg5, Xzg5^Es, Xzg5^Qov, Dd, Dd^Es, Rd, Dd, Re, Dd^Edp, Dd^Edp, Dd^Edp, Dd, Dd, Dd, Rd, Dd, Dd, Dd^Es, Dd, Dd, Dd, Dd, Dd, Dd, Dd, Dd, Rd, Dd, Rd, Dd, Rd, Rd, Rd, Re, Rd, Dd, Dd, Dd, Dd, Dd, Re, Dd, Re, Dd, Dd, Dd, Dd, Rd, Dd, Rd, Re, Rd, Dd^Edp, Dd^Edp, Dd^Edp, Dd^Edp, Dd, Dd^Es
Xzg4, Xzg4, Xzg5, Xzg5^Qov, Xzg5^Qov, Dd, Dd, Rd, Re, Rd, Dd^Edp, Dd^Edp, Dd^Edp, Dd, Dd, Dd, Dd, Dd, Dd^Es, Dd^Es, Dd^Edp, Dd^Edp, Dd, Dd, Dd, Dd, Dd, Dd, Dd, Dd^Es, Rd, Rd, Rd, Re, Dd, Rd, Dd, Dd, Dd, Rd, Rd, Rd, Dd, Dd, Dd^Es, Dd^Es, Dd, Rd, Dd, Dd, Dd, Dd, Dd, Rd, Re, Dd, Dd^Es, Dd, Rd
Xzg3, Xzg4, Xzg4, Xzg4^Qov, Xzg4^Qov, Xzg5^Qov, Dd, Dd, Dd, Re, Rd, Rd, Dd, Dd, Dd, Dd, Dd, Dd, Rd, Dd^Es, Dd, Dd^Edp, Dd, Dd, Rd, Dd^Edp, Dd, Dd, Dd^Es, Dd, Re, Rd, Rd, Dd, Dd, Dd, Dd, Dd, Dd, Rd, Dd, Dd, Dd, Dd^Es, Dd, Dd, Rd, Rd, Dd, Dd, Dd, Dd, Dd, Dd, Re, Rd, Re^Es, Rd, Rd
Xzg3, Xzg3, Xzg4, Xzg4, Xzg4, Xzg5^Qov, Xzg5^Qov, Xzg5^Qov, Dd, Rd, Dd, Dd, Dd, Dd, Dd, Rd, Dd, Re, Rd, Rd, Dd, Dd, Dd, 1 Rd, Dd^Edp, Dd^Edp, Dd, Dd, Dd, Rd, Rd, Re, Rd, Dd, Dd, Rd, Dd, Dd, Dd, Dd, Dd, Dd, Dd^Es, Dd, Dd, Rd, Rd, Dd, Dd, Dd, Dd, Dd, Dd^Edp, Dd, Dd^Edp, Re, Dd, Re, Dd
Xzg3, Xzg3, Xzg3, Xzg4, Xzg3, Xzg4, Xzg5, Xzg5^Qov, Xzg5^Qov, Dd, Xzg5^Qov, Xzg5^Qov, Xzg5^Qov, Xzg5^Qov, Dd, Rd, Dd, Re, Re^Es, Rd, Dd^Edp, Dd^Edp, Dd, Rd, Rd, Dd^Edp, Dd^Edp, Dd^Es, Dd, Dd, Re, Re, Re^Es, Dd^Es, Rd, Rd, Dd, Dd, Rd, Rd, Dd, Dd, Dd^Es, Dd, Dd, Re, Rd, Dd, Dd, Dd, Dd^Es, Dd, Dd^Edp, Dd^Edp, Dd^Es, Dd, Dd^Es, Dd, Dd
Xzg3^Es, Xzg3, Xzg3, Xzg3, Xzg3, Xzg4, Xzg5, Xzg5^Edp, Xzg5^Edp, Xzg5^Qov, Xzg4, Xzg4, Xzg4, Xzg5^Qov, Xzg5^Qov, Dd, Dd, Re, Dd, Re, Rd, Dd, Re, Re, Re, Dd, Dd, Dd, Dd^Es, Dd, Dd, Rd^Es, Re^Es, Rd^Es, Rd^Es, Rd, Rd, Rd, Dd, Rd, Dd, Dd, Dd, Dd, Re, Re, Dd, Dd, Dd^Es, Dd^Es, Dd, Dd, Dd, Dd^Edp, Dd^Edp, Dd^Es, Dd^Es, Dd, Dd
Xzg3, Xzg3^Es, Xzg3^Es, Re, Xzg3, Xzg4, Xzg4, Xzg4, Xzg4, Xzg5, Xzg4, Xzg4^Es, Xzg4^Es, Xzg4, Xzg5, Xzg5^Qov, Dd, Dd, Re, Re, Dd, Dd, Dd, Re, Re^Es, Re^Es, Re, Rd, Dd, Dd^Es, Dd, Dd, Re, Rd, Rd, Rd^Es, Dd, Rd, Dd, Dd, Dd, Dd, Rd, Re, Dd, Re, Dd, Dd, Dd, Dd, Dd, Dd, Dd, Dd^Edp, Dd, Dd^Es, Dd, Dd, Dd
Xzg3, Rd, Xzg3^Edp, Xzg3, Xzg3, Xzg3, Xzg4^Es, Xzg4^Es, Xzg4^Es, Xzg4, Re^Edp, Rd, Xzg4, Xzg4, Xzg5^Qov, Xzg5^Qov, Dd, Dd, Rd, Rd, Rd, Dd^Es, Rd, Rd, Re, Dd, Dd, Rd, Dd, Dd, Dd, Re, Re, Re, Re, Re, Dd, Dd, Dd, Dd, Dd, Dd, Re, Re, Dd, Rd, Dd, Dd^Es, Dd^Edp, Dd, Rd, Dd, Rd, Dd, Dd, Dd^Es, Dd, Dd, Dd
Xzg3, Rd, Re, Xzg3^Edp, Xzg3, Xzg3, Xzg3, Xzg4, Xzg3, Xzg4, Xzg4^Edp, Xzg4^Edp, Xzg4, Xzg5, Xzg5^Qov, Dd, Dd, Dd, Dd, Dd, Dd, Rd, Dd, Dd, Dd^Edp, Dd^Edp, Dd^Es, Dd^Es, Dd, Dd^Es, Dd^Es, Dd, Dd, Rd, Dd, Re, Re, Dd, Re, Re, Re, Rd, Re, Re, Rd^Es, Rd^Es, Dd, Dd^Edp, Dd^Edp, Re, Re, Rd, Dd, Rd, Rd, Rd, Rd, Dd, Dd
Xzg3, Rd, Re, Xzg3^Edp, Xzg3^Es, Xzg3, Xzg3, Xzg3, Xzg3, Xzg3, Xzg3, Xzg4^Es, Xzg4, Xzg5^Edp, Xzg5, Xzg5^Qov, Xzg5^Qov, Dd, Xzg5^Qov, Dd, Dd, Dd, Dd, Dd^Es, Dd, Dd, Dd, Dd^Es, Dd^Es, Dd, Dd, Dd^Edp, Dd^Edp, Dd, Dd, Rd, Rd, Re, Rd, Dd, Dd, Dd, Re, Re^Es, Re^Es, Dd^Es, Dd, Dd^Edp, Dd, Re, Re, Rd, Rd, Rd, Dd, Rd, Dd, Dd, Dd
Xzg3, Xzg3, Rd, Re, Rd, Xzg3, Re, Xzg3, Rd, Xzg3, Xzg3, Xzg4, Xzg4, Xzg4, Xzg4, Xzg4, Xzg4, Xzg5^Qov, Xzg4^Qov, Xzg5^Qov, Xzg5^Qov, Xzg5^Qov, Xzg5^Qov, Xzg5^Qov, Xzg5^Qov, Xzg5^Qov, Xzg5^Qov, Dd, Dd, Dd, Xzg5^Qov, Dd, Dd^Edp, Dd^Edp, Dd, Dd, Rd, Dd, Dd, Rd, Dd, Dd, Re, Re, Re, Rd, Dd^Edp, Dd^Edp, Dd, Re, Re, Re, Re, Dd, Dd^Edp, Rd, Dd^Es, Dd, Dd
Rd, Re^Es, Rd, Re, Re, Re, Re, Re, Xzg3, Xzg3^Es, Xzg3, Xzg3, Xzg3, Xzg4, Xzg3, Xzg3, Xzg3, Xzg4, Xzg4, Xzg4, Xzg5^Qov, Dd, Dd, Xzg5^Qov, Dd^Edp, Dd^Edp, Dd, Xzg5^Qov, Xzg5^Qov, Xzg5^Qov, Dd, Dd^Es, Dd, Dd^Edp, Rd, Rd, Dd, Dd, Dd, Dd, Dd, Dd, Dd, Rd, Rd, Re, Rd, Dd, Rd, Dd, Dd, Rd, Rd, Dd, Rd, Dd, Rd, Dd, Dd
Xzg3, Xzg3, Rd, Xzg3, Xzg3, Rd, Xzg3, Rd, Xzg3, Xzg3^Es, Xzg3, Xzg3, Xzg3, Xzg3, Xzg3, Xzg3, Xzg3, Xzg4, Xzg4, Xzg4, Xzg5, Xzg5^Qov, Dd, Dd, Dd, Dd, Dd, Dd, Dd, Xzg5^Qov, Dd, Dd, Dd, Dd, Rd, Rd, Dd, Dd, Dd, Dd, Dd, Dd^Edp, Dd, Dd, Dd, Dd, Dd, Rd, Rd, Dd, Dd, Dd, Dd, Rd, Dd, Rd, Dd, Dd, Dd
